Africanize = Africanise
Africanized = Africanised
Africanizes = Africanises
Africanizing = Africanising
Americanization = Americanisation
Americanize = Americanise
Americanized = Americanised
Americanizes = Americanises
Americanizing = Americanising
Anglicization = Anglicisation
Christianization = Christianisation
Christianize = Christianise
Christianized = Christianised
Christianizes = Christianises
Christianizing = Christianising
Gothicize = Gothicise
Gothicized = Gothicised
Gothicizes = Gothicises
Gothicizing = Gothicising
Islamize = Islamise
Islamized = Islamised
Islamizes = Islamises
Islamizing = Islamising
Italianize = Italianise
Italianized = Italianised
Italianizes = Italianises
Italianizing = Italianising
Latinize = Latinise
Latinized = Latinised
Latinizes = Latinises
Latinizing = Latinising
Romanize = Romanise
Romanized = Romanised
Romanizes = Romanises
Romanizing = Romanising
XRay = X-Ray
Xray = X-ray
aboveground = above-ground
accessorize = accessorise
accessorized = accessorised
accessorizes = accessorises
accessorizing = accessorising
acclimatization = acclimatisation
acclimatize = acclimatise
acclimatized = acclimatised
acclimatizes = acclimatises
acclimatizing = acclimatising
achromatize = achromatise
achromatized = achromatised
achromatizes = achromatises
achromatizing = achromatising
acquiesence = acquiescence
actualization = actualisation
actualize = actualise
actualized = actualised
actualizes = actualises
actualizing = actualising
aerosolize = aerosolise
aerosolized = aerosolised
aerosolizes = aerosolises
aerosolizing = aerosolising
aggrandise = aggrandize
aggrandised = aggrandized
aggrandises = aggrandizes
aggrandising = aggrandizing
agonize = agonise
agonized = agonised
agonizes = agonises
agonizing = agonising
alkalinize = alkalinise
alkalinized = alkalinised
alkalinizes = alkalinises
alkalinizing = alkalinising
alkalization = alkalisation
alkalize = alkalise
alkalized = alkalised
alkalizes = alkalises
alkalizing = alkalising
allegorize = allegorise
allegorized = allegorised
allegorizes = allegorises
allegorizing = allegorising
allinclusive = all-inclusive
alloimmunization = alloimmunizationisation
allover = all-over
alphabetization = alphabetisation
alphabetize = alphabetise
alphabetized = alphabetised
alphabetizes = alphabetises
alphabetizing = alphabetising
aluminize = aluminise
aluminized = aluminised
aluminizes = aluminises
aluminizing = aluminising
ameba = amoeba
amebas = amoebas
amebic = amoebic
amortizable = amortisable
amortization = amortisation
amortize = amortise
amortized = amortised
amortizes = amortises
amortizing = amortising
amphitheater = amphitheatre
amphitheaters = amphitheatres
anaesthetization = anaesthetisation
anaesthetize = anaesthetise
anaesthetized = anaesthetised
anaesthetizes = anaesthetises
anaesthetizing = anaesthetising
analog = analogue
analogize = analogise
analogized = analogised
analogizes = analogises
analogizing = analogising
analyze = analyse
analyzed = analysed
analyzer = analyser
analyzes = analyses
analyzing = analysing
anathematize = anathematise
anathematized = anathematised
anathematizes = anathematises
anathematizing = anathematising
anatomize = anatomise
anesthetize = anaesthetize
anesthetized = anaesthetized
anesthetizes = anaesthetizes
anesthetizing = anaesthetizing
anglicize = anglicise
anglicized = anglicised
anglicizes = anglicises
anglicizing = anglicising
animalize = animalise
animalized = animalised
animalizes = animalises
animalizing = animalising
annualize = annualise
annualized = annualised
annualizes = annualises
annualizing = annualising
annullment = annulment
anodize = anodise
anodized = anodised
anodizes = anodises
anodizing = anodising
antagonize = antagonise
antagonized = antagonised
antagonizes = antagonises
antagonizing = antagonising
anthologize = anthologise
anthologized = anthologised
anthologizes = anthologises
anthologizing = anthologising
anthropomorphize = anthropomorphise
anthropomorphized = anthropomorphised
anthropomorphizes = anthropomorphises
anthropomorphizing = anthropomorphising
anymore = any more
anytime = any time
apelike = ape-like
aphorize = aphorise
aphorized = aphorised
aphorizes = aphorises
aphorizing = aphorising
apnea = apnoea
apologize = apologise
apologized = apologised
apologizes = apologises
apologizing = apologising
apostatize = apostatise
apostatized = apostatised
apostatizes = apostatises
apostatizing = apostatising
apostrophize = apostrophise
apostrophized = apostrophised
apostrophizes = apostrophises
apostrophizing = apostrophising
apotheosize = apotheosise
apotheosized = apotheosised
apotheosizes = apotheosises
apotheosizing = apotheosising
appall = appal
appalls = appals
appetize = appetise
appetized = appetised
appetizer = appetiser
appetizers = appetisers
appetizes = appetises
appetizing = appetising
archaize = archaise
archaized = archaised
archaizes = archaises
archaizing = archaising
armor = armour
armored = armoured
aromatize = aromatise
aromatized = aromatised
aromatizes = aromatises
aromatizing = aromatising
artifacts = artefacts
asexualize = asexualise
asexualized = asexualised
asexualizes = asexualises
asexualizing = asexualising
atomization = atomisation
atomize = atomise
atomized = atomised
atomizer = atomiser
atomizers = atomisers
atomizes = atomises
atomizing = atomising
attitudinize = attitudinise
attitudinized = attitudinised
attitudinizes = attitudinises
attitudinizing = attitudinising
authorization = authorisation
authorizations = authorisations
authorize = authorise
authorized = authorised
authorizer = authoriser
authorizers = authorisers
authorizes = authorises
authorizing = authorising
baglike = bag-like
balkanization = balkanisation
balkanize = balkanise
balkanized = balkanised
balkanizes = balkanises
balkanizing = balkanising
baptize = baptise
baptized = baptised
baptizes = baptises
baptizing = baptising
barbarization = barbarisation
barbarize = barbarise
barbarized = barbarised
barbarizes = barbarises
barbarizing = barbarising
bastardization = bastardisation
bastardize = bastardise
bastardized = bastardised
bastardizes = bastardises
bastardizing = bastardising
behavior = behaviour
behavioral = behavioural
behaviors = behaviours
belabor = belabour
belabored = belaboured
belaboring = belabouring
belabors = belabours
bestialize = bestialise
bestialized = bestialised
bestializes = bestialises
bestializing = bestialising
biosynthesize = biosynthesise
biosynthesized = biosynthesised
biosynthesizes = biosynthesises
biosynthesizing = biosynthesising
bituminization = bituminisation
bituminize = bituminise
bituminized = bituminised
bituminizes = bituminises
bituminizing = bituminising
bladelike = blade-like
bonelike = bone-like
bowdlerization = bowdlerisation
bowdlerize = bowdlerise
bowdlerized = bowdlerised
bowdlerizes = bowdlerises
bowdlerizing = bowdlerising
brutalize = brutalise
brutalized = brutalised
brutalizes = brutalises
brutalizing = brutalising
bulblike = bulb-like
bureaucratization = bureaucratisation
bureaucratize = bureaucratise
bureaucratized = bureaucratised
bureaucratizes = bureaucratises
bureaucratizing = bureaucratising
burglarize = burglarise
burglarized = burglarised
burglarizes = burglarises
burglarizing = burglarising
businesslike = business-like
byproduct = by-product
byproducts = by-products
caliber = calibre
calibers = calibres
canalization = canalisation
canalize = canalise
canalized = canalised
canalizes = canalises
canalizing = canalising
canceled = cancelled
canceling = cancelling
candor = candour
cannibalization = cannibalisation
cannibalize = cannibalise
cannibalized = cannibalised
cannibalizes = cannibalises
cannibalizing = cannibalising
canonization = canonisation
canonizations = canonisations
canonize = canonise
canonized = canonised
canonizes = canonises
canonizing = canonising
capitalization = capitalisation
capitalizations = capitalisations
capitalize = capitalise
capitalized = capitalised
capitalizes = capitalises
capitalizing = capitalising
caponize = caponise
caponized = caponised
caponizes = caponises
caponizing = caponising
caramelize = caramelise
caramelized = caramelised
caramelizes = caramelises
caramelizing = caramelising
carbonization = carbonisation
carbonize = carbonise
carbonized = carbonised
carbonizes = carbonises
carbonizing = carbonising
carburize = carburise
carburized = carburised
carburizes = carburises
carburizing = carburising
catalog = catalogue
catalogs = catalogues
catalyze = catalyse
catalyzed = catalysed
catalyzes = catalyses
catalyzing = catalysing
catechization = catechisation
catechize = catechise
catechized = catechised
catechizer = catechiser
catechizers = catechisers
catechizes = catechises
catechizing = catechising
categorization = categorisation
categorize = categorise
categorized = categorised
categorizes = categorises
categorizing = categorising
catheterize = catheterise
catheterized = catheterised
catheterizes = catheterises
catheterizing = catheterising
catholicize = catholicise
catholicized = catholicised
catholicizes = catholicises
catholicizing = catholicising
cauterization = cauterisation
cauterize = cauterise
cauterized = cauterised
cauterizes = cauterises
cauterizing = cauterising
center = centre
centered = centred
centering = centring
centerpiece = centrepiece
centerpieces = centrepieces
centers = centres
centimeter = centimetre
centimeters = centimetres
centralization = centralisation
centralize = centralise
centralized = centralised
centralizer = centraliser
centralizers = centralisers
centralizes = centralises
centralizing = centralising
cephalization = cephalisation
cesium = caesium
channeled = channelled
channeling = channelling
characterization = characterisation
characterizations = characterisations
characterize = characterise
characterized = characterised
characterizes = characterises
characterizing = characterising
childlike = child-like
cicatrization = cicatrisation
cicatrize = cicatrise
cicatrized = cicatrised
cicatrizes = cicatrises
cicatrizing = cicatrising
circularization = circularisation
circularize = circularise
circularized = circularised
circularizes = circularises
circularizing = circularising
civilizable = civilisable
civilization = civilisation
civilizations = civilisations
civilize = civilise
civilized = civilised
civilizer = civiliser
civilizers = civilisers
civilizes = civilises
civilizing = civilising
clamor = clamour
clamored = clamoured
clamoring = clamouring
clamors = clamours
classicize = classicise
classicized = classicised
classicizes = classicises
classicizing = classicising
cliplike = clip-like
cognizable = cognisable
cognizably = cognisably
cognizance = cognisance
cognizant = cognisant
cognize = cognise
cognized = cognised
cognizes = cognises
cognizing = cognising
collateralize = collateralise
collateralized = collateralised
collateralizes = collateralises
collateralizing = collateralising
collectibles = collectables
collectivization = collectivisation
collectivize = collectivise
collectivized = collectivised
collectivizes = collectivises
collectivizing = collectivising
colonization = colonisation
colonize = colonise
colonized = colonised
colonizer = coloniser
colonizers = colonisers
colonizes = colonises
colonizing = colonising
color = colour
colored = coloured
colorful = colourful
colorfully = colourfully
coloring = colouring
colorize = colorise
colorized = colorised
colorizes = colorises
colorizing = colorising
colorless = colourless
colors = colours
commercialization = commercialisation
commercialize = commercialise
commercialized = commercialised
commercializes = commercialises
commercializing = commercialising
communalize = communalise
communalized = communalised
communalizes = communalises
communalizing = communalising
communization = communisation
communize = communise
communized = communised
communizes = communises
communizing = communising
compartmentalization = compartmentalisation
compartmentalize = compartmentalise
compartmentalized = compartmentalised
compartmentalizes = compartmentalises
compartmentalizing = compartmentalising
computerization = computerisation
computerize = computerise
computerized = computerised
computerizes = computerises
computerizing = computerising
conceptualization = conceptualisation
conceptualize = conceptualise
conceptualized = conceptualised
conceptualizes = conceptualises
conceptualizing = conceptualising
concretization = concretisation
concretize = concretise
concretized = concretised
concretizes = concretises
concretizing = concretising
containerization = containerisation
containerize = containerise
containerized = containerised
containerizes = containerises
containerizing = containerising
conventionalization = conventionalisation
conventionalize = conventionalise
conventionalized = conventionalised
conventionalizes = conventionalises
conventionalizing = conventionalising
cooperate = co-operate
cooperatively = co-operatively
coordinate = co-ordinate
coordinated = co-ordinated
coordinates = co-ordinates
coordinating = co-ordinating
counseled = counselled
counseling = counselling
counselor = counsellor
counselors = counsellors
counterargument = counter-argument
counterstrike = counter-strike
counterthrust = counter-thrust
criminalize = criminalise
criminalized = criminalised
criminalizes = criminalises
criminalizing = criminalising
criticize = criticise
criticized = criticised
criticizer = criticiser
criticizers = criticisers
criticizes = criticises
criticizing = criticising
crystallizable = crystallisable
crystallization = crystallisation
crystallize = crystallise
crystallized = crystallised
crystallizer = crystalliser
crystallizers = crystallisers
crystallizes = crystallises
crystallizing = crystallising
customizable = customisable
customization = customisation
customize = customise
customized = customised
customizes = customises
customizing = customising
decentralization = decentralisation
decentralizations = decentralisations
decentralize = decentralise
decentralized = decentralised
decentralizes = decentralises
decentralizing = decentralising
deciliter = decilitre
deciliters = decilitres
decimalization = decimalisation
decimalizations = decimalisations
decolonization = decolonisation
decolonizations = decolonisations
decolonize = decolonise
decolonized = decolonised
decolonizes = decolonises
decolonizing = decolonising
decolorize = decolorise
decolorized = decolorised
decolorizes = decolorises
decolorizing = decolorising
decriminalization = decriminalisation
decriminalize = decriminalise
decriminalized = decriminalised
decriminalizes = decriminalises
decriminalizing = decriminalising
defenses = defences
deglycerolize = deglycerolise
deglycerolized = deglycerolised
deglycerolizes = deglycerolises
deglycerolizing = deglycerolising
dehumanization = dehumanisation
dehumanize = dehumanise
dehumanized = dehumanised
dehumanizes = dehumanises
dehumanizing = dehumanising
deionization = deionisation
deionize = deionise
deionized = deionised
deionizes = deionises
deionizing = deionising
delocalize = delocalise
delocalized = delocalised
delocalizes = delocalises
delocalizing = delocalising
demagnetization = demagnetisation
demagnetize = demagnetise
demagnetized = demagnetised
demagnetizer = demagnetiser
demagnetizers = demagnetisers
demagnetizes = demagnetises
demagnetizing = demagnetising
dematerialization = dematerialisation
dematerialize = dematerialise
dematerialized = dematerialised
dematerializes = dematerialises
dematerializing = dematerialising
demeanor = demeanour
demilitarization = demilitarisation
demilitarize = demilitarise
demilitarized = demilitarised
demilitarizes = demilitarises
demilitarizing = demilitarising
demineralization = demineralisation
demineralize = demineralise
demineralized = demineralised
demineralizes = demineralises
demineralizing = demineralising
demobilization = demobilisation
demobilizations = demobilisations
demobilize = demobilise
demobilized = demobilised
demobilizes = demobilises
demobilizing = demobilising
democratization = democratisation
democratize = democratise
democratized = democratised
democratizes = democratises
democratizing = democratising
demonetize = demonetise
demonetized = demonetised
demonetizes = demonetises
demonetizing = demonetising
demonize = demonise
demonized = demonised
demonizes = demonises
demonizing = demonising
demoralization = demoralisation
demoralize = demoralise
demoralized = demoralised
demoralizer = demoraliser
demoralizers = demoralisers
demoralizes = demoralises
demoralizing = demoralising
demythologization = demythologisation
demythologize = demythologise
demythologized = demythologised
demythologizes = demythologises
demythologizing = demythologising
denationalization = denationalisation
denationalizations = denationalisations
denationalize = denationalise
denationalized = denationalised
denationalizes = denationalises
denationalizing = denationalising
denaturalization = denaturalisation
denaturalizations = denaturalisations
denaturalize = denaturalise
denaturalized = denaturalised
denaturalizes = denaturalises
denaturalizing = denaturalising
deodorize = deodorise
deodorized = deodorised
deodorizes = deodorises
deodorizing = deodorising
deoxidize = deoxidise
deoxidized = deoxidised
deoxidizer = deoxidiser
deoxidizers = deoxidisers
deoxidizes = deoxidises
deoxidizing = deoxidising
departmentalization = departmentalisation
departmentalize = departmentalise
departmentalized = departmentalised
departmentalizes = departmentalises
departmentalizing = departmentalising
dependents = dependants
depersonalization = depersonalisation
depersonalize = depersonalise
depersonalized = depersonalised
depersonalizes = depersonalises
depersonalizing = depersonalising
depolarization = depolarisation
depolarize = depolarise
depolarized = depolarised
depolarizer = depolariser
depolarizers = depolarisers
depolarizes = depolarises
depolarizing = depolarising
depressurization = depressurisation
depressurize = depressurise
depressurized = depressurised
depressurizes = depressurises
depressurizing = depressurising
deputize = deputise
deputized = deputised
deputizes = deputises
deputizing = deputising
desalinization = desalinisation
desalinize = desalinise
desalinized = desalinised
desalinizes = desalinises
desalinizing = desalinising
desensitization = desensitisation
desensitize = desensitise
desensitized = desensitised
desensitizer = desensitiser
desensitizers = desensitisers
desensitizes = desensitises
desensitizing = desensitising
desexualize = desexualise
desexualized = desexualised
desexualizes = desexualises
desexualizing = desexualising
despotize = despotise
despotized = despotised
despotizes = despotises
despotizing = despotising
destabilization = destabilisation
destabilize = destabilise
destabilized = destabilised
destabilizes = destabilises
destabilizing = destabilising
desynchronize = desynchronise
desynchronized = desynchronised
desynchronizes = desynchronises
desynchronizing = desynchronising
detribalize = detribalise
detribalized = detribalised
detribalizes = detribalises
detribalizing = detribalising
devitalize = devitalise
devitalized = devitalised
devitalizes = devitalises
devitalizing = devitalising
diagonalizable = diagonalisable
diarrhea = diarrhoea
diarrheaic = diarrhoeaic
diarrheal = diarrhoeal
dichotomization = dichotomisation
dichotomize = dichotomise
dichotomized = dichotomised
dichotomizes = dichotomises
dichotomizing = dichotomising
digitalization = digitalisation
digitalize = digitalise
digitalized = digitalised
digitalizes = digitalises
digitalizing = digitalising
digitization = digitisation
digitize = digitise
digitized = digitised
digitizer = digitiser
digitizers = digitisers
digitizes = digitises
digitizing = digitising
disfavor = disfavour
dishonor = dishonour
dishonorable = dishonourable
dishonored = dishonoured
dishonoring = dishonouring
dishonors = dishonours
disorganization = disorganisation
disorganize = disorganise
disorganized = disorganised
disorganizes = disorganises
disorganizing = disorganising
distills = distils
doglike = dog-like
dogmatize = dogmatise
dogmatized = dogmatised
dogmatizes = dogmatises
dogmatizing = dogmatising
downgraded = down-graded
dramatization = dramatisation
dramatize = dramatise
dramatized = dramatised
dramatizes = dramatises
dramatizing = dramatising
dreamlike = dream-like
earthborn = earth-born
ebonize = ebonise
ebonized = ebonised
ebonizes = ebonises
ebonizing = ebonising
economize = economise
economized = economised
economizer = economiser
economizers = economisers
economizes = economises
economizing = economising
editorialize = editorialise
editorialized = editorialised
editorializes = editorialises
editorializing = editorialising
effeminize = effeminise
effeminized = effeminised
effeminizes = effeminises
effeminizing = effeminising
eightfold = eight-fold
emblematize = emblematise
emotionalize = emotionalise
emotionalized = emotionalised
emotionalizes = emotionalises
emotionalizing = emotionalising
empathize = empathise
empathized = empathised
empathizes = empathises
empathizing = empathising
emphasize = emphasise
emphasized = emphasised
emphasizes = emphasises
emphasizing = emphasising
enamor = enamour
enamored = enamoured
enamoring = enamouring
enamors = enamours
encyclopedia = encyclopaedia
encyclopedias = encyclopaedias
encyclopedic = encyclopaedic
endeavor = endeavour
endeavored = endeavoured
endeavoring = endeavouring
endeavors = endeavours
energize = energise
energized = energised
energizer = energiser
energizers = energisers
energizes = energises
energizing = energising
enroll = enrol
enrollment = enrolment
enrolls = enrols
enthrall = enthral
enthralls = enthrals
eon = aeon
eons = aeons
epicenter = epicentre
epicenters = epicentres
epigrammatize = epigrammatise
epigrammatized = epigrammatised
epigrammatizes = epigrammatises
epigrammatizing = epigrammatising
epitomize = epitomise
epitomized = epitomised
epitomizes = epitomises
epitomizing = epitomising
equalization = equalisation
equalize = equalise
equalized = equalised
equalizer = equaliser
equalizers = equalisers
equalizes = equalises
equalizing = equalising
esophageal = oesophageal
esophagus = oesophagus
eternalize = eternalise
eternalized = eternalised
eternalizes = eternalises
eternalizing = eternalising
eternize = eternise
eternized = eternised
eternizes = eternises
eternizing = eternising
etherealize = etherealise
etherealized = etherealised
etherealizes = etherealises
etherealizing = etherealising
etherize = etherise
etherized = etherised
etherizes = etherises
etherizing = etherising
etymologize = etymologise
etymologized = etymologised
etymologizes = etymologises
etymologizing = etymologising
eulogize = eulogise
eulogized = eulogised
eulogizer = eulogiser
eulogizers = eulogisers
eulogizes = eulogises
eulogizing = eulogising
euphemize = euphemise
euphemized = euphemised
euphemizes = euphemises
euphemizing = euphemising
evangelization = evangelisation
evangelize = evangelise
evangelized = evangelised
evangelizes = evangelises
evangelizing = evangelising
exorcize = exorcise
exorcized = exorcised
exorcizes = exorcises
exorcizing = exorcising
extemporization = extemporisation
extemporize = extemporise
extemporized = extemporised
extemporizes = extemporises
extemporizing = extemporising
exteriorization = exteriorisation
exteriorize = exteriorise
exteriorized = exteriorised
exteriorizes = exteriorises
exteriorizing = exteriorising
externalization = externalisation
externalize = externalise
externalized = externalised
externalizes = externalises
externalizing = externalising
factorization = factorisation
factorize = factorise
factorized = factorised
factorizes = factorises
factorizing = factorising
familiarization = familiarisation
familiarize = familiarise
familiarized = familiarised
familiarizes = familiarises
familiarizing = familiarising
fanaticize = fanaticise
fanaticized = fanaticised
fanaticizes = fanaticises
fanaticizing = fanaticising
fantasize = fantasise
fantasized = fantasised
fantasizes = fantasises
fantasizing = fantasising
faradize = faradise
faradized = faradised
faradizes = faradises
faradizing = faradising
favor = favour
favorable = favourable
favorably = favourably
favored = favoured
favoring = favouring
favorite = favourite
favorites = favourites
favoritism = favouritism
favors = favours
federalization = federalisation
federalize = federalise
federalized = federalised
federalizes = federalises
federalizing = federalising
feminization = feminisation
feminize = feminise
feminized = feminised
feminizes = feminises
feminizing = feminising
fertilizable = fertilisable
fertilization = fertilisation
fertilize = fertilise
fertilized = fertilised
fertilizer = fertiliser
fertilizers = fertilisers
fertilizes = fertilises
fertilizing = fertilising
fervor = fervour
feudalize = feudalise
feudalized = feudalised
feudalizes = feudalises
feudalizing = feudalising
fiber = fibre
fiberglass = fibreglass
fibers = fibres
fictionalization = fictionalisation
fictionalize = fictionalise
fictionalized = fictionalised
fictionalizes = fictionalises
fictionalizing = fictionalising
finalization = finalisation
finalize = finalise
finalized = finalised
finalizes = finalises
finalizing = finalising
fingerlike = finger-like
fivefold = five-fold
flasklike = flask-like
fluidization = fluidisation
fluidize = fluidise
fluidized = fluidised
fluidizes = fluidises
fluidizing = fluidising
flulike = flu-like
focalization = focalisation
focalize = focalise
focalized = focalised
focalizes = focalises
focalizing = focalising
formalization = formalisation
formalize = formalise
formalized = formalised
formalizer = formaliser
formalizers = formalisers
formalizes = formalises
formalizing = formalising
formularize = formularise
formularized = formularised
formularizes = formularises
formularizing = formularising
formulize = formulise
formulized = formulised
formulizes = formulises
formulizing = formulising
fossilization = fossilisation
fossilize = fossilise
fossilized = fossilised
fossilizes = fossilises
fossilizing = fossilising
fractionalization = fractionalisation
fractionalize = fractionalise
fractionalized = fractionalised
fractionalizes = fractionalises
fractionalizing = fractionalising
fragmentize = fragmentise
fragmentized = fragmentised
fragmentizes = fragmentises
fragmentizing = fragmentising
fraternization = fraternisation
fraternize = fraternise
fraternized = fraternised
fraternizer = fraterniser
fraternizers = fraternisers
fraternizes = fraternises
fraternizing = fraternising
froglike = frog-like
frostbitten = frost-bitten
fueled = fuelled
fueling = fuelling
fulfill = fulfil
funneled = funnelled
funneling = funnelling
furor = furore
galvanization = galvanisation
galvanize = galvanise
galvanized = galvanised
galvanizer = galvaniser
galvanizers = galvanisers
galvanizes = galvanises
galvanizing = galvanising
gelatinize = gelatinise
gelatinized = gelatinised
gelatinizes = gelatinises
gelatinizing = gelatinising
generalization = generalisation
generalize = generalise
generalized = generalised
generalizes = generalises
generalizing = generalising
generelated = gene-related
geologize = geologise
geologized = geologised
geologizes = geologises
geologizing = geologising
geometrize = geometrise
geometrized = geometrised
geometrizes = geometrises
geometrizing = geometrising
germanize = germanise
germanized = germanised
germanizes = germanises
germanizing = germanising
germfree = germ-free
ghettoize = ghettoise
ghettoized = ghettoised
ghettoizes = ghettoises
ghettoizing = ghettoising
gigaliter = gigalitre
gigaliters = gigalitres
glamorization = glamorisation
glamorize = glamorise
glamorized = glamorised
glamorizes = glamorises
glamorizing = glamorising
globalization = globalisation
globalize = globalise
globalized = globalised
globalizes = globalises
globalizing = globalising
glycerolize = glycerolise
glycerolized = glycerolised
glycerolizes = glycerolises
glycerolizing = glycerolising
godlike = god-like
goiter = goitre
goiters = goitres
gonadotropin = gonadotrophin
gonadotropins = gonadotrophins
gonorrhea = gonorrhoea
gormandize = gourmandize
gourmandize = gourmandise
gourmandized = gourmandised
gourmandizes = gourmandises
gourmandizing = gourmandising
granulize = granulise
granulized = granulised
granulizes = granulises
granulizing = granulising
grapelike = grape-like
graphitize = graphitise
graphitized = graphitised
graphitizes = graphitises
graphitizing = graphitising
graying = greying
grueling = gruelling
gyrostabilizer = gyrostabiliser
gyrostabilizers = gyrostabilisers
hairlike = hair-like
halflife = half-life
harbor = harbour
harbored = harboured
harboring = harbouring
harbors = harbours
harddrive = hard drive
hardhearted = hard-hearted
harmonization = harmonisation
harmonize = harmonise
harmonized = harmonised
harmonizer = harmoniser
harmonizers = harmonisers
harmonizes = harmonises
harmonizing = harmonising
heathenize = heathenise
heathenized = heathenised
heathenizes = heathenises
heathenizing = heathenising
hemoglobin = haemoglobin
hemolyze = hemolyse
hemolyzing = hemolysing
hemorrhage = haemorrhage
hemorrhages = haemorrhages
hemorrhoid = haemorrhoid
hemorrhoids = haemorrhoids
heparinized = heparinizedised
highdose = high-dose
highstrung = high-strung
historicize = historicise
historicized = historicised
historicizes = historicises
historicizing = historicising
homogenization = homogenisation
homogenize = homogenise
homogenized = homogenised
homogenizer = homogeniser
homogenizers = homogenisers
homogenizes = homogenises
homogenizing = homogenising
honor = honour
honored = honoured
honoring = honouring
honors = honours
hospitalization = hospitalisation
hospitalize = hospitalise
hospitalized = hospitalised
hospitalizes = hospitalises
hospitalizing = hospitalising
humanization = humanisation
humanize = humanise
humanized = humanised
humanizer = humaniser
humanizers = humanisers
humanizes = humanises
humanizing = humanising
humanlike = human-like
humor = humour
humored = humoured
humoring = humouring
humorless = humourless
humors = humours
hyalinization = hyalinisation
hybridization = hybridizationisation
hybridize = hybridise
hybridized = hybridised
hybridizer = hybridiser
hybridizers = hybridisers
hybridizes = hybridises
hybridizing = hybridising
hydrolyze = hydrolyse
hydrolyzed = hydrolysed
hydrolyzes = hydrolyses
hydrolyzing = hydrolysing
hyperbolize = hyperbolise
hyperbolized = hyperbolised
hyperbolizes = hyperbolises
hyperbolizing = hyperbolising
hypercriticize = hypercriticise
hypercriticized = hypercriticised
hypercriticizes = hypercriticises
hypercriticizing = hypercriticising
hypnotizable = hypnotisable
hypnotize = hypnotise
hypnotized = hypnotised
hypnotizes = hypnotises
hypnotizing = hypnotising
hypoglycemic = hypoglycaemic
hypostatization = hypostatisation
hypothesize = hypothesise
hypothesized = hypothesised
hypothesizer = hypothesiser
hypothesizers = hypothesisers
hypothesizes = hypothesises
hypothesizing = hypothesising
idealization = idealisation
idealize = idealise
idealized = idealised
idealizer = idealiser
idealizers = idealisers
idealizes = idealises
idealizing = idealising
idolization = idolisation
idolize = idolise
idolized = idolised
idolizer = idoliser
idolizers = idolisers
idolizes = idolises
idolizing = idolising
immaterialize = immaterialise
immaterialized = immaterialised
immaterializes = immaterialises
immaterializing = immaterialising
immobilization = immobilisation
immobilize = immobilise
immobilized = immobilised
immobilizes = immobilises
immobilizing = immobilising
immortalization = immortalisation
immortalize = immortalise
immortalized = immortalised
immortalizer = immortaliser
immortalizers = immortalisers
immortalizes = immortalises
immortalizing = immortalising
immunization = immunisation
immunize = immunise
immunized = immunised
immunizes = immunises
immunizing = immunising
impersonalize = impersonalise
impersonalized = impersonalised
impersonalizes = impersonalises
impersonalizing = impersonalising
incognizance = incognisance
incognizant = incognisant
individualization = individualisation
individualize = individualise
individualized = individualised
individualizes = individualises
individualizing = individualising
industrialization = industrialisation
industrialize = industrialise
industrialized = industrialised
industrializes = industrialises
industrializing = industrialising
initialization = initialisation
initialize = initialise
initialized = initialised
initializes = initialises
initializing = initialising
installment = instalment
installments = instalments
instills = instils
institutionalization = institutionalisation
institutionalize = institutionalise
institutionalized = institutionalised
institutionalizes = institutionalises
institutionalizing = institutionalising
insulinlike = insulin-like
intellectualization = intellectualisation
intellectualize = intellectualise
intellectualized = intellectualised
intellectualizes = intellectualises
intellectualizing = intellectualising
interiorize = interiorise
interiorized = interiorised
interiorizes = interiorises
interiorizing = interiorising
internalization = internalisation
internalize = internalise
internalized = internalised
internalizes = internalises
internalizing = internalising
internationalization = internationalisation
internationalize = internationalise
internationalized = internationalised
internationalizes = internationalises
internationalizing = internationalising
iodize = iodise
iodized = iodised
iodizes = iodises
iodizing = iodising
ionizable = ionisable
ionization = ionisation
ionize = ionise
ionized = ionised
ionizer = ioniser
ionizers = ionisers
ionizes = ionises
ionizing = ionising
isoimmunization = isoimmunizationisation
italicization = italicisation
italicize = italicise
italicized = italicised
italicizes = italicises
italicizing = italicising
itemization = itemisation
itemize = itemise
itemized = itemised
itemizes = itemises
itemizing = itemising
jargonize = jargonise
jargonized = jargonised
jargonizes = jargonises
jargonizing = jargonising
jeopardize = jeopardise
jeopardized = jeopardised
jeopardizes = jeopardises
jeopardizing = jeopardising
jewelry = jewellery
journalize = journalise
journalized = journalised
journalizes = journalises
journalizing = journalising
keratinized = keratinizedised
kilometer = kilometre
kilometers = kilometres
labeled = labelled
labeling = labelling
labialize = labialise
labialized = labialised
labializes = labialises
labializing = labialising
labor = labour
labored = laboured
laborer = labourer
laborers = labourers
laboring = labouring
labors = labours
latticework = lattice-work
legalization = legalisation
legalize = legalise
legalized = legalised
legalizes = legalises
legalizing = legalising
legitimatize = legitimatise
legitimatized = legitimatised
legitimatizes = legitimatises
legitimatizing = legitimatising
legitimization = legitimisation
legitimize = legitimise
legitimized = legitimised
legitimizes = legitimises
legitimizing = legitimising
lemmatization = lemmatisation
lemmatize = lemmatise
lemmatized = lemmatised
lemmatizes = lemmatises
lemmatizing = lemmatising
leveled = levelled
leveling = levelling
liberalization = liberalisation
liberalize = liberalise
liberalized = liberalised
liberalizer = liberaliser
liberalizers = liberalisers
liberalizes = liberalises
liberalizing = liberalising
licenses = licences
lifelike = life-like
lifetime = life-time
lionization = lionisation
lionize = lionise
lionized = lionised
lionizer = lioniser
lionizers = lionisers
lionizes = lionises
lionizing = lionising
liquidize = liquidise
liquidized = liquidised
liquidizes = liquidises
liquidizing = liquidising
liter = litre
liters = litres
liveborn = live-born
lobotomize = lobotomise
lobotomized = lobotomised
lobotomizes = lobotomises
lobotomizing = lobotomising
localizable = localisable
localization = localisation
localize = localise
localized = localised
localizer = localiser
localizers = localisers
localizes = localises
localizing = localising
longstanding = long-standing
longterm = long-term
longtime = long-time
lookout = look-out
lowcarbohydrate = low-carbohydrate
lowdose = low-dose
lowprotein = low-protein
luster = lustre
lyophilize = lyophilise
lyophilized = lyophilised
lyophilizes = lyophilises
lyophilizing = lyophilising
macadamize = macadamise
macadamized = macadamised
macadamizes = macadamises
macadamizing = macadamising
magnetization = magnetisation
magnetize = magnetise
magnetized = magnetised
magnetizer = magnetiser
magnetizers = magnetisers
magnetizes = magnetises
magnetizing = magnetising
maneuver = manoeuvre
maneuvered = manoeuvred
maneuvering = manoeuvring
maneuvers = manoeuvres
manyfold = many-fold
marbleize = marbleise
marbleized = marbleised
marbleizes = marbleises
marbleizing = marbleising
marginalize = marginalise
marginalized = marginalised
marginalizes = marginalises
marginalizing = marginalising
martialed = martialled
martialing = martialling
marvelous = marvellous
masculinization = masculinizationisation
materialization = materialisation
materialize = materialise
materialized = materialised
materializes = materialises
materializing = materialising
maximization = maximisation
maximize = maximise
maximized = maximised
maximizes = maximises
maximizing = maximising
mechanization = mechanisation
mechanize = mechanise
mechanized = mechanised
mechanizes = mechanises
mechanizing = mechanising
megaliter = megalitre
megaliters = megalitres
megalopolize = megalopolise
megalopolized = megalopolised
megalopolizes = megalopolises
megalopolizing = megalopolising
memorialize = memorialise
memorialized = memorialised
memorializes = memorialises
memorializing = memorialising
memorization = memorisation
memorize = memorise
memorized = memorised
memorizes = memorises
memorizing = memorising
mercerization = mercerisation
mercerize = mercerise
mercerized = mercerised
mercerizes = mercerises
mercerizing = mercerising
mesmerize = mesmerise
mesmerized = mesmerised
mesmerizes = mesmerises
mesmerizing = mesmerising
metabolize = metabolise
metabolized = metabolised
metabolizes = metabolises
metabolizing = metabolising
metastasize = metastasise
metastasized = metastasised
metastasizes = metastasises
metastasizing = metastasising
methodize = methodise
methodized = methodised
methodizes = methodises
methodizing = methodising
micrometers = micrometres
microminiaturize = microminiaturise
microminiaturized = microminiaturised
microminiaturizes = microminiaturises
microminiaturizing = microminiaturising
militarization = militarisation
militarize = militarise
militarized = militarised
militarizes = militarises
militarizing = militarising
milliliter = millilitre
milliliters = millilitres
millimeter = millimetre
millimeters = millimetres
mineralize = mineralise
mineralized = mineralised
mineralizes = mineralises
mineralizing = mineralising
miniaturization = miniaturisation
miniaturize = miniaturise
miniaturized = miniaturised
miniaturizes = miniaturises
miniaturizing = miniaturising
minimization = minimisation
minimize = minimise
minimized = minimised
minimizes = minimises
minimizing = minimising
misbehavior = misbehaviour
mischaracterize = mischaracterise
mischaracterized = mischaracterised
mischaracterizes = mischaracterises
mischaracterizing = mischaracterising
mobilization = mobilisation
mobilize = mobilise
mobilized = mobilised
mobilizer = mobiliser
mobilizers = mobilisers
mobilizes = mobilises
mobilizing = mobilising
modeled = modelled
modeling = modelling
modernization = modernisation
modernize = modernise
modernized = modernised
modernizes = modernises
modernizing = modernising
modularize = modularise
modularized = modularised
modularizes = modularises
modularizing = modularising
moisturize = moisturise
moisturized = moisturised
moisturizer = moisturiser
moisturizers = moisturisers
moisturizes = moisturises
moisturizing = moisturising
mold = mould
moldable = mouldable
molders = moulders
molding = moulding
molds = moulds
mongrelize = mongrelise
mongrelized = mongrelised
mongrelizes = mongrelises
mongrelizing = mongrelising
monopolization = monopolisation
monopolize = monopolise
monopolized = monopolised
monopolizes = monopolises
monopolizing = monopolising
monumentalize = monumentalise
monumentalized = monumentalised
monumentalizes = monumentalises
monumentalizing = monumentalising
moralization = moralisation
moralize = moralise
moralized = moralised
moralizer = moraliser
moralizers = moralisers
moralizes = moralises
moralizing = moralising
motorization = motorisation
motorize = motorise
motorized = motorised
motorizes = motorises
motorizing = motorising
municipalize = municipalise
municipalized = municipalised
municipalizes = municipalises
municipalizing = municipalising
myelinization = myelinizationisation
mythologize = mythologise
mythologized = mythologised
mythologizes = mythologises
mythologizing = mythologising
nanometer = nanometre
nanometers = nanometres
narcotize = narcotise
narcotized = narcotised
narcotizes = narcotises
narcotizing = narcotising
nationalization = nationalisation
nationalizations = nationalisations
nationalize = nationalise
nationalized = nationalised
nationalizes = nationalises
nationalizing = nationalising
naturalization = naturalisation
naturalize = naturalise
naturalized = naturalised
naturalizes = naturalises
naturalizing = naturalising
naysayer = nay-sayer
nebulization = nebulizationisation
neighbor = neighbour
neighborhood = neighbourhood
neighborhoods = neighbourhoods
neighboring = neighbouring
neighbors = neighbours
neovascularization = neovascularizationisation
neutralization = neutralisation
neutralize = neutralise
neutralized = neutralised
neutralizer = neutraliser
neutralizers = neutralisers
neutralizes = neutralises
neutralizing = neutralising
ninefold = nine-fold
nonabrasive = non-abrasive
nonaddictive = non-addictive
nonaffected = unaffected
nondepolarizing = nondepolarizingising
nonidiomatic = non-idiomatic
nonpartisan = non-partisan
nonprofessional = non-professional
nonreligious = non-religious
nonsexual = non-sexual
nonstandard = non-standard
nontransparent = non-transparent
nonzero = non-zero
normalization = normalisation
normalizations = normalisations
normalize = normalise
normalized = normalised
normalizes = normalises
normalizing = normalising
notarization = notarisation
notarize = notarise
notarized = notarised
notarizes = notarises
notarizing = notarising
novelize = novelise
novelized = novelised
novelizes = novelises
novelizing = novelising
odor = odour
odorize = odorise
odorized = odorised
odorizes = odorises
odorizing = odorising
odors = odours
offenses = offences
ongoing = on-going
opioidlike = opioid-like
opsonization = opsonizationisation
opsonize = opsonizeise
opsonized = opsonizedised
opsonizing = opsonizingising
optimization = optimisation
optimizations = optimisations
optimize = optimise
optimized = optimised
optimizer = optimiser
optimizers = optimisers
optimizes = optimises
optimizing = optimising
organisational = organizational
organization = organisation
organizations = organisations
organize = organise
organized = organised
organizer = organiser
organizers = organisers
organizes = organises
organizing = organising
ostracize = ostracise
ostracized = ostracised
ostracizes = ostracises
ostracizing = ostracising
overcapitalization = overcapitalisation
overcapitalize = overcapitalise
overcapitalized = overcapitalised
overcapitalizes = overcapitalises
overcapitalizing = overcapitalising
overemphasize = overemphasise
overemphasized = overemphasised
overemphasizes = overemphasises
overemphasizing = overemphasising
overspecialization = overspecialisation
overspecialize = overspecialise
overspecialized = overspecialised
overspecializes = overspecialises
overspecializing = overspecialising
oxidization = oxidisation
oxidize = oxidise
oxidized = oxidised
oxidizer = oxidiser
oxidizers = oxidisers
oxidizes = oxidises
oxidizing = oxidising
oxygenize = oxygenise
oxygenized = oxygenised
oxygenizes = oxygenises
oxygenizing = oxygenising
palatalize = palatalise
palatalized = palatalised
palatalizes = palatalises
palatalizing = palatalising
paleontologist = palaeontologist
paleontologists = palaeontologists
paleontology = palaeontology
palletize = palletise
palletized = palletised
palletizes = palletises
palletizing = palletising
panegyrize = panegyrise
panegyrized = panegyrised
panegyrizes = panegyrises
panegyrizing = panegyrising
panelize = panelise
panelized = panelised
panelizes = panelises
panelizing = panelising
paralyze = paralyse
paralyzed = paralysed
paralyzes = paralyses
paralyzing = paralysing
parameterization = parameterisation
parameterize = parameterise
parameterized = parameterised
parameterizes = parameterises
parameterizing = parameterising
parasitize = parasitise
parasitized = parasitised
parasitizes = parasitises
parasitizing = parasitising
parceled = parcelled
parceling = parcelling
parenthesize = parenthesise
parenthesized = parenthesised
parenthesizes = parenthesises
parenthesizing = parenthesising
particularization = particularisation
particularize = particularise
particularized = particularised
particularizes = particularises
particularizing = particularising
pasteurization = pasteurisation
pasteurize = pasteurise
pasteurized = pasteurised
pasteurizes = pasteurises
pasteurizing = pasteurising
patronization = patronisation
patronize = patronise
patronized = patronised
patronizes = patronises
patronizing = patronising
pauperization = pauperisation
pauperize = pauperise
pauperized = pauperised
pauperizes = pauperises
pauperizing = pauperising
penalization = penalisation
penalize = penalise
penalized = penalised
penalizes = penalises
penalizing = penalising
peptize = peptise
peptized = peptised
peptizes = peptises
peptizing = peptising
personalization = personalisation
personalize = personalise
personalized = personalised
personalizes = personalises
personalizing = personalising
philosophize = philosophise
philosophized = philosophised
philosophizer = philosophiser
philosophizers = philosophisers
philosophizes = philosophises
philosophizing = philosophising
phlebotomize = phlebotomise
phlebotomized = phlebotomised
phlebotomizes = phlebotomises
phlebotomizing = phlebotomising
photosensitization = photosensitisation
photosensitize = photosensitise
photosensitized = photosensitised
photosensitizes = photosensitises
photosensitizing = photosensitising
photosynthesize = photosynthesise
photosynthesized = photosynthesised
photosynthesizes = photosynthesises
photosynthesizing = photosynthesising
plagiarize = plagiarise
plagiarized = plagiarised
plagiarizer = plagiariser
plagiarizers = plagiarisers
plagiarizes = plagiarises
plagiarizing = plagiarising
plantlike = plant-like
pluralize = pluralise
pluralized = pluralised
pluralizes = pluralises
pluralizing = pluralising
poeticize = poeticise
poeticized = poeticised
poeticizes = poeticises
poeticizing = poeticising
poetize = poetise
poetized = poetised
poetizes = poetises
poetizing = poetising
polarization = polarisation
polarize = polarise
polarized = polarised
polarizes = polarises
polarizing = polarising
politicization = politicisation
politicize = politicise
politicized = politicised
politicizes = politicises
politicizing = politicising
polymerization = polymerizationisation
polymerize = polymerise
polymerized = polymerised
polymerizes = polymerises
polymerizing = polymerising
popularization = popularisation
popularize = popularise
popularized = popularised
popularizes = popularises
popularizing = popularising
preauthorize = preauthorise
preauthorized = preauthorised
preauthorizes = preauthorises
preauthorizing = preauthorising
precognizant = precognisant
preempt = pre-empt
preexisting = pre-existing
pressurization = pressurisation
pressurize = pressurise
pressurized = pressurised
pressurizes = pressurises
pressurizing = pressurising
pretense = pretence
pretenses = pretences
prioritization = prioritisation
prioritize = prioritise
prioritized = prioritised
prioritizes = prioritises
prioritizing = prioritising
privatization = privatisation
privatize = privatise
privatized = privatised
privatizes = privatises
privatizing = privatising
propagandize = propagandise
propagandized = propagandised
propagandizes = propagandises
propagandizing = propagandising
proselytize = proselytise
proselytized = proselytised
proselytizer = proselytiser
proselytizers = proselytisers
proselytizes = proselytises
proselytizing = proselytising
proteinlike = protein-like
proteinmediated = protein-mediated
proteinrelated = protein-related
publicize = publicise
publicized = publicised
publicizes = publicises
publicizing = publicising
pulverization = pulverisation
pulverize = pulverise
pulverized = pulverised
pulverizes = pulverises
pulverizing = pulverising
rabbeting = rabbetting
radicalization = radicalisation
radicalize = radicalise
radicalized = radicalised
radicalizes = radicalises
radicalizing = radicalising
rancor = rancour
randomization = randomisation
randomize = randomise
randomized = randomised
randomizer = randomiser
randomizers = randomisers
randomizes = randomises
randomizing = randomising
rapidacting = rapid-acting
rationalization = rationalisation
rationalize = rationalise
rationalized = rationalised
rationalizes = rationalises
rationalizing = rationalising
reacclimatize = reacclimatise
reacclimatized = reacclimatised
reacclimatizes = reacclimatises
reacclimatizing = reacclimatising
realizable = realisable
realization = realisation
realize = realise
realized = realised
realizes = realises
realizing = realising
reauthorization = reauthorisation
reauthorize = reauthorise
reauthorized = reauthorised
reauthorizes = reauthorises
reauthorizing = reauthorising
recognizable = recognisable
recognizably = recognisably
recognizance = recognisance
recognize = recognise
recognized = recognised
recognizer = recogniser
recognizers = recognisers
recognizes = recognises
recognizing = recognising
reconnoiter = reconnoitre
reconnoitered = reconnoitred
reconnoitering = reconnoitring
reconnoiters = reconnoitres
reeducate = re-educate
reenact = re-enact
reenlisting = re-enlisting
reenter = re-enter
reentered = re-entered
reentering = re-entering
reenters = re-enters
reestablish = re-establish
reestablished = re-established
reestablishing = re-establishing
reestablishment = re-establishment
reesterified = re-esterified
reexamine = re-examine
reexploration = re-exploration
refueled = refuelled
refueling = refuelling
regionalize = regionalise
regionalized = regionalised
regionalizes = regionalises
regionalizing = regionalising
regularization = regularisation
regularize = regularise
regularized = regularised
regularizes = regularises
regularizing = regularising
reinitialize = reinitialise
reinitialized = reinitialised
reinitializes = reinitialises
reinitializing = reinitialising
rematerialize = rematerialise
rematerialized = rematerialised
rematerializes = rematerialises
rematerializing = rematerialising
remilitarization = remilitarisation
remilitarize = remilitarise
remilitarized = remilitarised
remilitarizes = remilitarises
remilitarizing = remilitarising
remobilization = remobilisation
remobilize = remobilise
remobilized = remobilised
remobilizes = remobilises
remobilizing = remobilising
remodeled = remodelled
remodeling = remodelling
remoulds = remolds
renormalize = renormalise
renormalized = renormalised
renormalizes = renormalises
renormalizing = renormalising
reorganization = reorganisation
reorganize = reorganise
reorganized = reorganised
reorganizer = reorganiser
reorganizers = reorganisers
reorganizes = reorganises
reorganizing = reorganising
reprioritization = reprioritisation
reutilize = reutilise
reutilized = reutilised
reutilizes = reutilises
reutilizing = reutilising
revalorization = revalorisation
reveled = revelled
reveling = revelling
revitalization = revitalisation
revitalize = revitalise
revitalized = revitalised
revitalizes = revitalises
revitalizing = revitalising
revolutionize = revolutionise
revolutionized = revolutionised
revolutionizes = revolutionises
revolutionizing = revolutionising
rhapsodize = rhapsodise
rhapsodized = rhapsodised
rhapsodizes = rhapsodises
rhapsodizing = rhapsodising
rigors = rigours
ringlike = ring-like
ritualize = ritualise
ritualized = ritualised
ritualizes = ritualises
ritualizing = ritualising
rivaled = rivalled
rivaling = rivalling
robotize = robotise
robotized = robotised
robotizes = robotises
robotizing = robotising
rodlike = rod-like
romanticize = romanticise
romanticized = romanticised
romanticizes = romanticises
romanticizing = romanticising
rubberize = rubberise
rubberized = rubberised
rubberizes = rubberises
rubberizing = rubberising
rumor = rumour
rumored = rumoured
rumors = rumours
saber = sabre
sabered = sabred
sabers = sabres
saclike = sac-like
sanitization = sanitisation
sanitize = sanitise
sanitized = sanitised
sanitizer = sanitiser
sanitizers = sanitisers
sanitizes = sanitises
sanitizing = sanitising
satirize = satirise
satirized = satirised
satirizes = satirises
satirizing = satirising
savior = saviour
saviors = saviours
savored = savoured
savoring = savouring
savors = savours
scandalize = scandalise
scandalized = scandalised
scandalizes = scandalises
scandalizing = scandalising
scepter = sceptre
sceptered = sceptred
scepters = sceptres
schematization = schematisation
schematize = schematise
schematized = schematised
schematizes = schematises
schematizing = schematising
scrutinize = scrutinise
scrutinized = scrutinised
scrutinizer = scrutiniser
scrutinizers = scrutinisers
scrutinizes = scrutinises
scrutinizing = scrutinising
sectionalize = sectionalise
sectionalized = sectionalised
sectionalizes = sectionalises
sectionalizing = sectionalising
secularization = secularisation
secularize = secularise
secularized = secularised
secularizer = seculariser
secularizers = secularisers
secularizes = secularises
secularizing = secularising
sensationalize = sensationalise
sensationalized = sensationalised
sensationalizes = sensationalises
sensationalizing = sensationalising
sensitization = sensitisation
sensitize = sensitise
sensitized = sensitised
sensitizes = sensitises
sensitizing = sensitising
sentimentalization = sentimentalisation
sentimentalize = sentimentalise
sentimentalized = sentimentalised
sentimentalizes = sentimentalises
sentimentalizing = sentimentalising
sepulcher = sepulchre
serialization = serialisation
serialize = serialise
serialized = serialised
serializes = serialises
serializing = serialising
sermonize = sermonise
sermonized = sermonised
sermonizer = sermoniser
sermonizers = sermonisers
sermonizes = sermonises
sermonizing = sermonising
sevenfold = seven-fold
severalfold = several-fold
sexualize = sexualise
sexualized = sexualised
sexualizes = sexualises
sexualizing = sexualising
sheikdom = sheikhdom
sheikdoms = sheikhdoms
sheiks = sheikhs
shocklike = shock-like
shortterm = short-term
shoveled = shovelled
shoveling = shovelling
shriveled = shrivelled
shriveling = shrivelling
signaled = signalled
signaling = signalling
signalization = signalisation
signalize = signalise
signalized = signalised
signalizes = signalises
signalizing = signalising
simonize = simonise
simonized = simonised
simonizes = simonises
simonizing = simonising
singularize = singularise
singularized = singularised
singularizes = singularises
singularizing = singularising
sixfold = six-fold
skillful = skilful
skillfully = skilfully
skillfulness = skilfulness
slenderize = slenderise
slenderized = slenderised
slenderizes = slenderises
slenderizing = slenderising
slitlike = slit-like
smolder = smoulder
snakelike = snake-like
sniveling = snivelling
socialization = socialisation
socialize = socialise
socialized = socialised
socializes = socialises
socializing = socialising
sodomize = sodomise
sodomized = sodomised
sodomizes = sodomises
sodomizing = sodomising
solemnization = solemnisation
solemnize = solemnise
solemnized = solemnised
solemnizes = solemnises
solemnizing = solemnising
soliloquize = soliloquise
soliloquized = soliloquised
soliloquizes = soliloquises
soliloquizing = soliloquising
soundproof = sound-proof
spadelike = spade-like
specialization = specialisation
specialize = specialise
specialized = specialised
specializes = specialises
specializing = specialising
specter = spectre
specters = spectres
spiraled = spiralled
spiraling = spiralling
spiritualization = spiritualisation
spiritualize = spiritualise
spiritualized = spiritualised
spiritualizes = spiritualises
spiritualizing = spiritualising
splendor = splendour
stabilization = stabilisation
stabilize = stabilise
stabilized = stabilised
stabilizer = stabiliser
stabilizers = stabilisers
stabilizes = stabilises
stabilizing = stabilising
standardization = standardisation
standardize = standardise
standardized = standardised
standardizes = standardises
standardizing = standardising
sterilization = sterilisation
sterilize = sterilise
sterilized = sterilised
sterilizer = steriliser
sterilizers = sterilisers
sterilizes = sterilises
sterilizing = sterilising
stigmatization = stigmatisation
stigmatize = stigmatise
stigmatized = stigmatised
stigmatizes = stigmatises
stigmatizing = stigmatising
stonelike = stone-like
stressrelated = stress-related
structuralize = structuralise
structuralized = structuralised
structuralizes = structuralises
structuralizing = structuralising
stylization = stylisation
stylize = stylise
stylized = stylised
stylizes = stylises
stylizing = stylising
subcategorize = subcategorise
subcategorized = subcategorised
subcategorizes = subcategorises
subcategorizing = subcategorising
subsidization = subsidisation
subsidize = subsidise
subsidized = subsidised
subsidizer = subsidiser
subsidizers = subsidisers
subsidizes = subsidises
subsidizing = subsidising
suburbanize = suburbanise
suburbanized = suburbanised
suburbanizes = suburbanises
suburbanizing = suburbanising
succor = succour
sulfate = sulphate
sulfates = sulphates
sulfite = sulphite
sulfites = sulphites
sulfonylurea = sulphonylurea
sulfonylureas = sulphonylureas
sulfur = sulphur
summarization = summarisation
summarize = summarise
summarized = summarised
summarizer = summariser
summarizers = summarisers
summarizes = summarises
summarizing = summarising
swiveled = swivelled
swiveling = swivelling
symbolization = symbolisation
symbolize = symbolise
symbolized = symbolised
symbolizes = symbolises
symbolizing = symbolising
sympathize = sympathise
sympathized = sympathised
sympathizer = sympathiser
sympathizers = sympathisers
sympathizes = sympathises
sympathizing = sympathising
symphonize = symphonise
symphonized = symphonised
symphonizes = symphonises
symphonizing = symphonising
synchronization = synchronisation
synchronize = synchronise
synchronized = synchronised
synchronizer = synchroniser
synchronizers = synchronisers
synchronizes = synchronises
synchronizing = synchronising
synopsize = synopsise
synopsized = synopsised
synopsizes = synopsises
synopsizing = synopsising
synthesize = synthesise
synthesized = synthesised
synthesizer = synthesiser
synthesizers = synthesisers
synthesizes = synthesises
synthesizing = synthesising
systematization = systematisation
systematize = systematise
systematized = systematised
systematizes = systematises
systematizing = systematising
systemization = systemisation
systemize = systemise
systemized = systemised
systemizes = systemises
systemizing = systemising
tabularize = tabularise
tabularized = tabularised
tabularizes = tabularises
tabularizing = tabularising
tantalization = tantalisation
tantalize = tantalise
tantalized = tantalised
tantalizer = tantaliser
tantalizers = tantalisers
tantalizes = tantalises
tantalizing = tantalising
temporization = temporisation
temporize = temporise
temporized = temporised
temporizer = temporiser
temporizers = temporisers
temporizes = temporises
temporizing = temporising
tenderization = tenderisation
tenderize = tenderise
tenderized = tenderised
tenderizer = tenderiser
tenderizers = tenderisers
tenderizes = tenderises
tenderizing = tenderising
terrorization = terrorisation
terrorize = terrorise
terrorized = terrorised
terrorizes = terrorises
terrorizing = terrorising
theater = theatre
theaters = theatres
theologize = theologise
theologized = theologised
theologizes = theologises
theologizing = theologising
theorization = theorisation
theorize = theorise
theorized = theorised
theorizer = theoriser
theorizers = theorisers
theorizes = theorises
theorizing = theorising
threadlike = thread-like
threefold = three-fold
thyroxin = thyroxine
titer = titre
titered = titred
titers = titres
toothlike = tooth-like
toothproducing = tooth-producing
totaled = totalled
totaling = totalling
traditionalize = traditionalise
traditionalized = traditionalised
traditionalizes = traditionalises
traditionalizing = traditionalising
tranquilization = tranquilisation
tranquilize = tranquilise
tranquilized = tranquilised
tranquilizer = tranquiliser
tranquilizers = tranquilisers
tranquilizes = tranquilises
tranquilizing = tranquilising
tranquillisation = tranquillization
tranquillise = tranquillize
tranquillised = tranquillized
tranquilliser = tranquillizer
tranquillisers = tranquillizers
tranquillises = tranquillizes
tranquillising = tranquillizing
transistorize = transistorise
transistorized = transistorised
transistorizes = transistorises
transistorizing = transistorising
traumatize = traumatise
traumatized = traumatised
traumatizes = traumatises
traumatizing = traumatising
traveled = travelled
traveler = traveller
travelers = travellers
traveling = travelling
treelike = tree-like
trivialization = trivialisation
trivialize = trivialise
trivialized = trivialised
trivializes = trivialises
trivializing = trivialising
tumor = tumour
tumors = tumours
twofold = two-fold
tyrannize = tyrannise
tyrannized = tyrannised
tyrannizes = tyrannises
tyrannizing = tyrannising
unappetize = unappetise
unappetized = unappetised
unappetizes = unappetises
unappetizing = unappetising
unauthorize = unauthorise
unauthorized = unauthorised
unauthorizes = unauthorises
unauthorizing = unauthorising
uncapitalize = uncapitalise
uncapitalized = uncapitalised
uncapitalizes = uncapitalises
uncapitalizing = uncapitalising
uncategorize = uncategorise
uncategorized = uncategorised
uncategorizes = uncategorises
uncategorizing = uncategorising
uncharacterize = uncharacterise
uncharacterized = uncharacterised
uncharacterizes = uncharacterises
uncharacterizing = uncharacterising
uncivilize = uncivilise
uncivilized = uncivilised
uncivilizes = uncivilises
uncivilizing = uncivilising
uncompromize = uncompromise
uncompromized = uncompromised
uncompromizes = uncompromises
uncompromizing = uncompromising
undercapitalize = undercapitalise
undercapitalized = undercapitalised
undercapitalizes = undercapitalises
undercapitalizing = undercapitalising
underutilization = underutilisation
underutilize = underutilise
underutilized = underutilised
underutilizes = underutilises
underutilizing = underutilising
undervirilization = undervirilizationisation
undramatize = undramatise
undramatized = undramatised
undramatizes = undramatises
undramatizing = undramatising
unfavorable = unfavourable
unfavorably = unfavourably
unfertilize = unfertilise
unfertilized = unfertilised
unfertilizes = unfertilises
unfertilizing = unfertilising
unimmunized = unimmunizedised
unindustrialize = unindustrialise
unindustrialized = unindustrialised
unindustrializes = unindustrialises
unindustrializing = unindustrialising
unionization = unionisation
unionize = unionise
unionized = unionised
unionizes = unionises
unionizing = unionising
unitization = unitisation
unitize = unitise
unitized = unitised
unitizes = unitises
unitizing = unitising
universalize = universalise
universalized = universalised
universalizes = universalises
universalizing = universalising
unmechanize = unmechanise
unmechanized = unmechanised
unmechanizes = unmechanises
unmechanizing = unmechanising
unorganize = unorganise
unorganized = unorganised
unorganizes = unorganises
unorganizing = unorganising
unpasteurize = unpasteurise
unpasteurized = unpasteurised
unpasteurizes = unpasteurises
unpasteurizing = unpasteurising
unraveled = unravelled
unraveling = unravelling
unrealizable = unrealisable
unrealize = unrealise
unrealized = unrealised
unrealizes = unrealises
unrealizing = unrealising
unrecognizable = unrecognisable
unrecognize = unrecognise
unrecognized = unrecognised
unrecognizes = unrecognises
unrecognizing = unrecognising
unrivaled = unrivalled
unrivaling = unrivalling
unromanticize = unromanticise
unromanticized = unromanticised
unromanticizes = unromanticises
unromanticizing = unromanticising
unsavory = unsavoury
unspecialize = unspecialise
unspecialized = unspecialised
unspecializes = unspecialises
unspecializing = unspecialising
unsubsidize = unsubsidise
unsubsidized = unsubsidised
unsubsidizes = unsubsidises
unsubsidizing = unsubsidising
unsupervize = unsupervise
unsupervized = unsupervised
unsupervizes = unsupervises
unsupervizing = unsupervising
unsynchronize = unsynchronise
unsynchronized = unsynchronised
unsynchronizes = unsynchronises
unsynchronizing = unsynchronising
unutilize = unutilise
unutilized = unutilised
unutilizes = unutilises
unutilizing = unutilising
urbanization = urbanisation
urbanize = urbanise
urbanized = urbanised
urbanizes = urbanises
urbanizing = urbanising
utilizable = utilisable
utilization = utilisation
utilize = utilise
utilized = utilised
utilizes = utilises
utilizing = utilising
vacuolization = vacuolisation
valor = valour
valorization = valorisation
valorize = valorise
valorized = valorised
valorizes = valorises
valorizing = valorising
vandalize = vandalise
vandalized = vandalised
vandalizes = vandalises
vandalizing = vandalising
vapor = vapour
vaporizable = vaporisable
vaporization = vaporisation
vaporize = vaporise
vaporized = vaporised
vaporizer = vaporiser
vaporizers = vaporisers
vaporizes = vaporises
vaporizing = vaporising
vapors = vapours
vascularization = vascularizationisation
vascularized = vascularizedised
verbalization = verbalisation
verbalize = verbalise
verbalized = verbalised
verbalizes = verbalises
verbalizing = verbalising
vestlike = vest-like
victimization = victimisation
victimize = victimise
victimized = victimised
victimizer = victimiser
victimizers = victimisers
victimizes = victimises
victimizing = victimising
vigor = vigour
virilized = virilizedised
virtualize = virtualise
virtualized = virtualised
virtualizes = virtualises
virtualizing = virtualising
visualization = visualisation
visualize = visualise
visualized = visualised
visualizes = visualises
visualizing = visualising
vitalization = vitalisation
vitalize = vitalise
vitalized = vitalised
vitalizes = vitalises
vitalizing = vitalising
vocalization = vocalisation
vocalize = vocalise
vocalized = vocalised
vocalizes = vocalises
vocalizing = vocalising
volatilization = volatilisation
volatilize = volatilise
volatilized = volatilised
volatilizes = volatilises
volatilizing = volatilising
vulcanization = vulcanisation
vulcanize = vulcanise
vulcanized = vulcanised
vulcanizes = vulcanises
vulcanizing = vulcanising
vulgarization = vulgarisation
vulgarize = vulgarise
vulgarized = vulgarised
vulgarizes = vulgarises
vulgarizing = vulgarising
warlike = war-like
waterpermeable = water-permeable
wavelike = wave-like
weatherize = weatherise
weatherized = weatherised
weatherizes = weatherises
weatherizing = weatherising
weightbearing = weight-bearing
westernization = westernisation
westernize = westernise
westernized = westernised
westernizes = westernises
westernizing = westernising
whiplike = whip-like
winterization = winterisation
winterize = winterise
winterized = winterised
winterizes = winterises
winterizing = winterising
womanize = womanise
womanized = womanised
womanizer = womaniser
womanizers = womanisers
womanizes = womanises
womanizing = womanising
woodlike = wood-like
workup = work-up
wormlike = worm-like
xray = X-ray
yearend = year-end
yearlong = year-long
yieldfree = yield-free
