Africanise = Africanize
Africanised = Africanized
Africanises = Africanizes
Africanising = Africanizing
Americanisation = Americanization
Americanise = Americanize
Americanised = Americanized
Americanises = Americanizes
Americanising = Americanizing
Anglicisation = Anglicization
Christianisation = Christianization
Christianise = Christianize
Christianised = Christianized
Christianises = Christianizes
Christianising = Christianizing
DHEAS = DHEA-S
Gothicise = Gothicize
Gothicised = Gothicized
Gothicises = Gothicizes
Gothicising = Gothicizing
Hürtle = Hürthle
Islamise = Islamize
Islamised = Islamized
Islamises = Islamizes
Islamising = Islamizing
Italianise = Italianize
Italianised = Italianized
Italianises = Italianizes
Italianising = Italianizing
Latinise = Latinize
Latinised = Latinized
Latinises = Latinizes
Latinising = Latinizing
MEN1associated = MEN1-associated
MEN1like = MEN1-like
MEN1related = MEN1-related
MEN2related = MEN2-related
P450dependent = P450-dependent
P450like = P450-like
P450linked = P450-linked
Rhpositive = Rh-positive
Romanise = Romanize
Romanised = Romanized
Romanises = Romanizes
Romanising = Romanizing
XRay = X-Ray
Xlike = X-like
Xray = X-ray
abelcet = Abelcet
abetalipoproteinaemia = abetalipoproteinemia
abetalipoproteinaemic = abetalipoproteinemic
aboveground = above-ground
abraxane = Abraxane
abreva = Abreva
accessorise = accessorize
accessorised = accessorized
accessorises = accessorizes
accessorising = accessorizing
acclimatisation = acclimatization
acclimatise = acclimatize
acclimatised = acclimatized
acclimatises = acclimatizes
acclimatising = acclimatizing
accolate = Accolate
accupril = Accupril
accuretic = Accuretic
acenaesthesia = acenesthesia
acetonaemia = acetonemia
acetonaemic = acetonemic
acetyltransferase = acetyl-transferase
achromatise = achromatize
achromatised = achromatized
achromatises = achromatizes
achromatising = achromatizing
acidaemia = acidemia
acidaemias = acidemias
acidaemic = acidemic
acidinduced = acid-induced
aclasta = Aclasta
acquiesence = acquiescence
acroanaesthesia = acroanesthesia
acroparaesthesia = acroparesthesia
actonel = Actonel
actos = Actos
actualisation = actualization
actualise = actualize
actualised = actualized
actualises = actualizes
actualising = actualizing
acular = Acular
acyltransferase = acyl-transferase
aczone = Aczone
adderall = Adderall
adrenalinaemia = adrenalinemia
adrenalinaemic = adrenalinemic
advagraf = Advagraf
advair = Advair
advicor = Advicor
aeon = eon
aeons = eons
aerius = Aerius
aerocoele = aerocele
aerosolise = aerosolize
aerosolised = aerosolized
aerosolises = aerosolizes
aerosolising = aerosolizing
aesthesioneuroblastoma = esthesioneuroblastoma
aesthesioneuroma = esthesioneuroma
aesthesioneurosis = esthesioneurosis
aetiocholanolone = etiocholanolone
aetiologic = etiologic
aetiological = etiological
aetiologies = etiologies
aetiology = etiology
aetiopathogenesis = etiopathogenesis
aetiotropic = etiotropic
afibrinogenaemia = afibrinogenemia
afibrinogenaemic = afibrinogenemic
agammaglobulinaemia = agammaglobulinemia
agammaglobulinaemic = agammaglobulinemic
agenerase = Agenerase
aggrandize = aggrandise
aggrandized = aggrandised
aggrandizes = aggrandises
aggrandizing = aggrandising
aggrastat = Aggrastat
aglycaemia = aglycemia
aglycaemic = aglycemic
agonise = agonize
agonised = agonized
agonises = agonizes
agonising = agonizing
airomir = Airomir
alarlike = alar-like
aldara = Aldara
aleukaemia = aleukemia
aleukaemic = aleukemic
alfaxan = Alfaxan
alimta = Alimta
alkalaemia = alkalemia
alkalinise = alkalinize
alkalinised = alkalinized
alkalinises = alkalinizes
alkalinising = alkalinizing
alkalisation = alkalization
alkalise = alkalize
alkalised = alkalized
alkalises = alkalizes
alkalising = alkalizing
alkeran = Alkeran
allachaesthesia = allachesthesia
allegorise = allegorize
allegorised = allegorized
allegorises = allegorizes
allegorising = allegorizing
allegra = Allegra
alliaesthesia = alliesthesia
allinclusive = all-inclusive
alloimmunizationisation = alloimmunization
allover = all-over
alora = Alora
alphabetisation = alphabetization
alphabetise = alphabetize
alphabetised = alphabetized
alphabetises = alphabetizes
alphabetising = alphabetizing
alrex = Alrex
altace = Altace
aluminise = aluminize
aluminised = aluminized
aluminises = aluminizes
aluminising = aluminizing
aluminum = aluminium
alvesco = Alvesco
amenorrhoea = amenorrhea
amenorrhoeic = amenorrheic
amerge = Amerge
aminoacidaemia = aminoacidemia
aminoacidaemic = aminoacidemic
ammonaemia = ammonemia
ammonaemic = ammonemic
ammoniaemia = ammoniemia
ammoniaemic = ammoniemic
amoeba = ameba
amoebae = amebae
amoebas = amebas
amoebic = amebic
amoeboid = ameboid
amortisable = amortizable
amortisation = amortization
amortise = amortize
amortised = amortized
amortises = amortizes
amortising = amortizing
amphitheater = amphitheatre
amphitheaters = amphitheatres
amphotec = Amphotec
anacataesthesia = anacatesthesia
anaemia = anemia
anaemias = anemias
anaemic = anemic
anaesthekinesia = anesthekinesia
anaesthesia = anesthesia
anaesthesiologist = anesthesiologist
anaesthesiologists = anesthesiologists
anaesthesiology = anesthesiology
anaesthetic = anesthetic
anaesthetics = anesthetics
anaesthetisation = anaesthetization
anaesthetise = anaesthetize
anaesthetised = anaesthetized
anaesthetises = anaesthetizes
anaesthetising = anaesthetizing
anaesthetist = anesthetist
anaesthetizedised = anaesthetized
analog = analogue
analogise = analogize
analogised = analogized
analogises = analogizes
analogising = analogizing
analyze = analyse
analyzed = analysed
analyzer = analyser
analyzes = analyses
analyzing = analysing
anathematise = anathematize
anathematised = anathematized
anathematises = anathematizes
anathematising = anathematizing
anatomise = anatomize
andriol = Andriol
androderm = Androderm
androgalactozaemia = androgalactozemia
androgalactozaemic = androgalactozemic
angeliq = Angeliq
angiaesthenia = angiesthenia
angiomax = Angiomax
angiooedema = angioedema
anglicise = anglicize
anglicised = anglicized
anglicises = anglicizes
anglicising = anglicizing
animalise = animalize
animalised = animalized
animalises = animalizes
animalising = animalizing
anipryl = Anipryl
annualise = annualize
annualised = annualized
annualises = annualizes
annualising = annualizing
annullment = annulment
anodise = anodize
anodised = anodized
anodises = anodizes
anodising = anodizing
anoxaemia = anoxemia
anoxaemic = anoxemic
antagonise = antagonize
antagonised = antagonized
antagonises = antagonizes
antagonising = antagonizing
anthologise = anthologize
anthologised = anthologized
anthologises = anthologizes
anthologising = anthologizing
anthropomorphise = anthropomorphize
anthropomorphised = anthropomorphized
anthropomorphises = anthropomorphizes
anthropomorphising = anthropomorphizing
anti-amoebic = anti-amebic
antiabortion = anti-abortion
antiacetylcholine = anti-acetylcholine
antialdosterone = anti-aldosterone
antianaemia = antianemia
antianaemic = antianemic
antianaphylaxis = anti-anaphylaxis
antiandrogen = anti-androgen
antiandrogens = anti-androgens
antianginal = anti-anginal
antianxiety = anti-anxiety
antiarrhythmic = anti-arrhythmic
antiarrhythmics = anti-arrhythmics
antiarthritics = anti-arthritics
antiatherogenic = anti-atherogenic
antibacterial = anti-bacterial
anticancer = anti-cancer
anticarcinogenic = anti-carcinogenic
anticardiolipin = anti-cardiolipin
anticentromere = anti-centromere
anticholagogue = anti-cholagogue
anticholinergic = anti-cholinergic
anticholinergics = anti-cholinergics
anticholinesterase = anti-cholinesterase
anticholinesterases = anti-cholinesterases
anticoagulate = anti-coagulate
anticoagulated = anti-coagulated
anticoagulation = anti-coagulation
antideoxyribonuclease = anti-deoxyribonuclease
antidepressant = anti-depressant
antidepressants = anti-depressants
antidiabetic = anti-diabetic
antidiarrhoeal = antidiarrheal
antidiarrhoeals = antidiarrheals
antidiphtheritic = anti-diphtheritic
antidisease = anti-disease
antidiuresis = anti-diuresis
antiduretic = anti-duretic
antiembolic = anti-embolic
antiemetic = anti-emetic
antiemetics = anti-emetics
antiendotoxin = anti-endotoxin
antiepileptic = anti-epileptic
antifailure = anti-failure
antifebrile = anti-febrile
antifibrinolytics = anti-fibrinolytics
antifibrotic = anti-fibrotic
antiflatulants = anti-flatulants
antifolate = anti-folate
antifungal = anti-fungal
antifungals = anti-fungals
antigalactic = anti-galactic
antigenically = anti-genically
antigenicity = anti-genicity
antiglomerular = anti-glomerular
antigonorrhoeic = antigonorrheic
antihaemorrhagic = antihemorrhagic
antihelminthics = anti-helminthics
antihelmintic = anti-helmintic
antihemophilic = anti-hemophilic
antihero = anti-hero
antihistone = anti-histone
antihormone = anti-hormone
antihormones = anti-hormones
antihydropic = anti-hydropic
antihypercholesterolaemia = antihypercholesterolemia
antihypercholesterolaemic = antihypercholesterolemic
antihypertensive = anti-hypertensive
antihypertensives = anti-hypertensives
antihypnotic = anti-hypnotic
antiinflammatories = anti-inflammatories
antiinflammatory = anti-inflammatory
antiketogenesis = anti-ketogenesis
antiketogenic = anti-ketogenic
antileishmanial = anti-leishmanial
antileprosy = anti-leprosy
antileprotic = anti-leprotic
antileukaemic = antileukemic
antilipaemia = antilipemia
antilipaemic = antilipemic
antilithic = anti-lithic
antiliver = anti-liver
antilymphocyte = anti-lymphocyte
antilyssic = anti-lyssic
antimalaria = anti-malaria
antimalarial = anti-malarial
antimalarials = anti-malarials
antimanic = anti-manic
antimeningococcal = anti-meningococcal
antimetabolite = anti-metabolite
antimetotic = anti-metotic
antimetropia = anti-metropia
antimicrobial = anti-microbial
antimicrobials = anti-microbials
antimineralocorticoid = anti-mineralocorticoid
antimissile = anti-missile
antimitochondrial = anti-mitochondrial
antimitotic = anti-mitotic
antimonials = anti-monials
antimuscarinic = anti-muscarinic
antimycobacterial = anti-mycobacterial
antinative = anti-native
antinatriuresis = anti-natriuresis
antineoplastics = anti-neoplastics
antinephritic = anti-nephritic
antineuralgic = anti-neuralgic
antineutrino = anti-neutrino
antineutrophil = anti-neutrophil
antinuclear = anti-nuclear
antiodontalgic = anti-odontalgic
antioestrogen = anti-oestrogen
antiovarian = anti-ovarian
antioxidant = anti-oxidant
antioxidants = anti-oxidants
antipaludian = anti-paludian
antiparathyroid = anti-parathyroid
antiparkinsonian = anti-parkinsonian
antipenstalsis = anti-penstalsis
antipersonnel = anti-personnel
antiphlogistic = anti-phlogistic
antiphospholipid = anti-phospholipid
antipneumococcal = anti-pneumococcal
antiprostaglandin = anti-prostaglandin
antipruritic = anti-pruritic
antipseudomonal = anti-pseudomonal
antipsychotic = anti-psychotic
antipsychotics = anti-psychotics
antiputrifactive = anti-putrifactive
antipyogenic = anti-pyogenic
antipyrotic = anti-pyrotic
antirabies = anti-rabies
antireflective = anti-reflective
antirejection = anti-rejection
antiresorptive = anti-resorptive
antirheumatic = anti-rheumatic
antirheumatics = anti-rheumatics
antirheumatoid = anti-rheumatoid
antisaepsis = anti-saepsis
antischistosomal = anti-schistosomal
antiseborrhoeic = anti-seborrhoeic
antiserotonin = anti-serotonin
antishock = anti-shock
antisialagogue = anti-sialagogue
antisialic = anti-sialic
antismooth = anti-smooth
antisocial = anti-social
antispasmodic = anti-spasmodic
antispasmodics = anti-spasmodics
antispastic = anti-spastic
antistaphylococcal = anti-staphylococcal
antistreptococcal = anti-streptococcal
antistreptolysin = anti-streptolysin
antisubmarine = anti-submarine
antisyphilitic = anti-syphilitic
antitachycardia = anti-tachycardia
antitetanic = anti-tetanic
antithrombotic = anti-thrombotic
antithrombotics = anti-thrombotics
antithymocyte = anti-thymocyte
antithyroid = anti-thyroid
antitoxigen = anti-toxigen
antitrombotic = anti-trombotic
antitrypsin = anti-trypsin
antitubercular = anti-tubercular
antituberculous = anti-tuberculous
antitumour = anti-tumour
antityphoid = anti-typhoid
antiulceratives = anti-ulceratives
antivaccinationist = anti-vaccinationist
antivenom = anti-venom
antivirals = anti-virals
antixerotic = anti-xerotic
antizymotic = anti-zymotic
antrocoele = antrocele
anymore = any more
anytime = any time
apallaesthesia = apallesthesia
apelike = ape-like
aphaeresis = apheresis
aphorise = aphorize
aphorised = aphorized
aphorises = aphorizes
aphorising = aphorizing
apnoea = apnea
apnoeas = apneas
apnoeic = apneic
apologise = apologize
apologised = apologized
apologises = apologizes
apologising = apologizing
apostatise = apostatize
apostatised = apostatized
apostatises = apostatizes
apostatising = apostatizing
apostrophise = apostrophize
apostrophised = apostrophized
apostrophises = apostrophizes
apostrophising = apostrophizing
apotheosise = apotheosize
apotheosised = apotheosized
apotheosises = apotheosizes
apotheosising = apotheosizing
appall = appal
appalls = appals
appetise = appetize
appetised = appetized
appetiser = appetizer
appetisers = appetizers
appetises = appetizes
appetising = appetizing
aptivus = Aptivus
aranesp = Aranesp
archaise = archaize
archaised = archaized
archaises = archaizes
archaising = archaizing
arestin = Arestin
argininosuccinicacidaemia = argininosuccinicacidemia
argininosuccinicacidaemic = argininosuccinicacidemic
aricept = Aricept
arimidex = Arimidex
armor = armour
armored = armoured
aromasin = Aromasin
aromatise = aromatize
aromatised = aromatized
aromatises = aromatizes
aromatising = aromatizing
arthrocoele = arthrocele
arthrotec = Arthrotec
artifacts = artefacts
asacol = Asacol
asaemia = asemia
asaemic = asemic
asexualise = asexualize
asexualised = asexualized
asexualises = asexualizes
asexualising = asexualizing
asmanex = Asmanex
asmax = Asmax
atacand = Atacand
ataxiophaemia = ataxiophemia
ataxiophaemic = ataxiophemic
athyroidaemia = athyroidemia
athyroidaemic = athyroidemic
atomisation = atomization
atomise = atomize
atomised = atomized
atomiser = atomizer
atomisers = atomizers
atomises = atomizes
atomising = atomizing
atraemia = atremia
atraemic = atremic
atrovent = Atrovent
attenade = Attenade
attitudinise = attitudinize
attitudinised = attitudinized
attitudinises = attitudinizes
attitudinising = attitudinizing
audioanaesthesia = audioanesthesia
authorisation = authorization
authorisations = authorizations
authorise = authorize
authorised = authorized
authoriser = authorizer
authorisers = authorizers
authorises = authorizes
authorising = authorizing
autohaemia = autohemia
autohaemic = autohemic
autosepticaemia = autosepticemia
autosepticaemic = autosepticemic
autotoxaemia = autotoxemia
autotoxaemic = autotoxemic
avalide = Avalide
avamys = Avamys
avandamet = Avandamet
avandaryl = Avandaryl
avandia = Avandia
avapro = Avapro
avastin = Avastin
avelox = Avelox
aviax = Aviax
avodart = Avodart
axert = Axert
azactam = Azactam
azasite = Azasite
azilect = Azilect
azopt = Azopt
azotaemia = azotemia
azotaemic = azotemic
bacillaemia = bacillemia
bacillaemic = bacillemic
bacteraemia = bacteremia
bacteraemic = bacteremic
baglike = bag-like
balkanisation = balkanization
balkanise = balkanize
balkanised = balkanized
balkanises = balkanizes
balkanising = balkanizing
baptise = baptize
baptised = baptized
baptises = baptizes
baptising = baptizing
baraclude = Baraclude
barbarisation = barbarization
barbarise = barbarize
barbarised = barbarized
barbarises = barbarizes
barbarising = barbarizing
bastardisation = bastardization
bastardise = bastardize
bastardised = bastardized
bastardises = bastardizes
bastardising = bastardizing
bathyanaesthesia = bathyanesthesia
baycol = Baycol
baytril = Baytril
behavior = behaviour
behavioral = behavioural
behaviors = behaviours
belabor = belabour
belabored = belaboured
belaboring = belabouring
belabors = belabours
bestialise = bestialize
bestialised = bestialized
bestialises = bestializes
bestialising = bestializing
betahaemolytic = betahemolytic
betaseron = Betaseron
bextra = Bextra
biallelic = bi-allelic
biaxin = Biaxin
bilirubinaemia = bilirubinemia
bilirubinaemic = bilirubinemic
biopravastatin = Biopravastatin
biosynthesise = biosynthesize
biosynthesised = biosynthesized
biosynthesises = biosynthesizes
biosynthesising = biosynthesizing
biphentin = Biphentin
bituminisation = bituminization
bituminise = bituminize
bituminised = bituminized
bituminises = bituminizes
bituminising = bituminizing
bladelike = blade-like
blenorrhoea = blenorrhea
bonelike = bone-like
bonviva = Bonviva
botox = Botox
bowdlerisation = bowdlerization
bowdlerise = bowdlerize
bowdlerised = bowdlerized
bowdlerises = bowdlerizes
bowdlerising = bowdlerizing
bradypnoea = bradypnea
brevibloc = Brevibloc
bronchiocoele = bronchiocele
bronchocoele = bronchocele
bronchorrhoea = bronchorrhea
brutalise = brutalize
brutalised = brutalized
brutalises = brutalizes
brutalising = brutalizing
bucnaemia = bucnemia
bucnaemic = bucnemic
bulblike = bulb-like
bureaucratisation = bureaucratization
bureaucratise = bureaucratize
bureaucratised = bureaucratized
bureaucratises = bureaucratizes
bureaucratising = bureaucratizing
burglarise = burglarize
burglarised = burglarized
burglarises = burglarizes
burglarising = burglarizing
businesslike = business-like
byproduct = by-product
byproducts = by-products
caduet = Caduet
caecal = cecal
caecum = cecum
caelyx = Caelyx
calcaemia = calcemia
calcaemic = calcemic
caliber = calibre
calibers = calibres
camptosar = Camptosar
canalisation = canalization
canalise = canalize
canalised = canalized
canalises = canalizes
canalising = canalizing
canceled = cancelled
canceling = cancelling
cancidas = Cancidas
candidaemia = candidemia
candor = candour
cannibalisation = cannibalization
cannibalise = cannibalize
cannibalised = cannibalized
cannibalises = cannibalizes
cannibalising = cannibalizing
canonisation = canonization
canonisations = canonizations
canonise = canonize
canonised = canonized
canonises = canonizes
canonising = canonizing
capitalisation = capitalization
capitalisations = capitalizations
capitalise = capitalize
capitalised = capitalized
capitalises = capitalizes
capitalising = capitalizing
caponise = caponize
caponised = caponized
caponises = caponizes
caponising = caponizing
capstar = Capstar
caramelise = caramelize
caramelised = caramelized
caramelises = caramelizes
caramelising = caramelizing
carbigran = Carbigran
carbonaemia = carbonemia
carbonaemic = carbonemic
carbonisation = carbonization
carbonise = carbonize
carbonised = carbonized
carbonises = carbonizes
carbonising = carbonizing
carboxyhaemoglobin = carboxyhemoglobin
carburise = carburize
carburised = carburized
carburises = carburizes
carburising = carburizing
cardiocoele = cardiocele
cardioprotective = cardio-protective
cardiorrhoexis = cardiorrhexis
cardioselective = cardio-selective
cardizem = Cardizem
catalog = catalogue
catalogs = catalogues
catalyze = catalyse
catalyzed = catalysed
catalyzes = catalyses
catalyzing = catalysing
catechisation = catechization
catechise = catechize
catechised = catechized
catechiser = catechizer
catechisers = catechizers
catechises = catechizes
catechising = catechizing
categorisation = categorization
categorise = categorize
categorised = categorized
categorises = categorizes
categorising = categorizing
catena = Catena
catheterise = catheterize
catheterised = catheterized
catheterises = catheterizes
catheterising = catheterizing
catheterizedised = catheterized
catheterrelated = catheter-related
catholicise = catholicize
catholicised = catholicized
catholicises = catholicizes
catholicising = catholicizing
cauterisation = cauterization
cauterise = cauterize
cauterised = cauterized
cauterises = cauterizes
cauterising = cauterizing
ceclor = Ceclor
cefizox = Cefizox
ceftin = Ceftin
celebrex = Celebrex
celexa = Celexa
cellcept = Cellcept
cellmediated = cell-mediated
cellstimulating = cell-stimulating
celsentri = Celsentri
cenaesthesia = cenesthesia
center = centre
centered = centred
centering = centring
centerpiece = centrepiece
centerpieces = centrepieces
centers = centres
centimeter = centimetre
centimeters = centimetres
centralisation = centralization
centralise = centralize
centralised = centralized
centraliser = centralizer
centralisers = centralizers
centralises = centralizes
centralising = centralizing
cephalhaematoma = cephalhematoma
cephalhematocoele = cephalhematocele
cephalisation = cephalization
cephalocoele = cephalocele
cerenia = Cerenia
cerezyme = Cerezyme
cesium = caesium
cetrotide = Cetrotide
champix = Champix
channelblocking = channel-blocking
channeled = channelled
channeling = channelling
characterisation = characterization
characterisations = characterizations
characterise = characterize
characterised = characterized
characterises = characterizes
characterising = characterizing
chemotherapyrelated = chemotherapy-related
childlike = child-like
chloridaemia = chloridemia
chloridaemic = chloridemic
cholaemia = cholemia
cholaemic = cholemic
choriocoele = choriocele
choroideraemia = choroideremia
choroideraemic = choroideremic
chromatinnegative = chromatin-negative
chromatinpositive = chromatin-positive
chromosomespecific = chromosome-specific
chylomicronaemia = chylomicronemia
chylomicronaemic = chylomicronemic
cialis = Cialis
cicatrisation = cicatrization
cicatrise = cicatrize
cicatrised = cicatrized
cicatrises = cicatrizes
cicatrising = cicatrizing
cipralex = Cipralex
cipro = Cipro
ciprodex = Ciprodex
circularisation = circularization
circularise = circularize
circularised = circularized
circularises = circularizes
circularising = circularizing
citrateinitiated = citrate-initiated
citrullinaemia = citrullinemia
citrullinaemic = citrullinemic
civilisable = civilizable
civilisation = civilization
civilisations = civilizations
civilise = civilize
civilised = civilized
civiliser = civilizer
civilisers = civilizers
civilises = civilizes
civilising = civilizing
clamor = clamour
clamored = clamoured
clamoring = clamouring
clamors = clamours
claricid = Claricid
classicise = classicize
classicised = classicized
classicises = classicizes
classicising = classicizing
clindoxyl = Clindoxyl
cliplike = clip-like
clobex = Clobex
coactivator = co-activator
coactivators = co-activators
coadministration = co-administration
coeliac = celiac
coelioscopy = celioscopy
coexpressed = co-expressed
coexpression = co-expression
cognisable = cognizable
cognisably = cognizably
cognisance = cognizance
cognisant = cognizant
cognise = cognize
cognised = cognized
cognises = cognizes
cognising = cognizing
colitoxaemia = colitoxemia
colitoxaemic = colitoxemic
collateralise = collateralize
collateralised = collateralized
collateralises = collateralizes
collateralising = collateralizing
collectibles = collectables
collectivisation = collectivization
collectivise = collectivize
collectivised = collectivized
collectivises = collectivizes
collectivising = collectivizing
colonisation = colonization
colonise = colonize
colonised = colonized
coloniser = colonizer
colonisers = colonizers
colonises = colonizes
colonising = colonizing
color = colour
colored = coloured
colorful = colourful
colorfully = colourfully
coloring = colouring
colorise = colorize
colorised = colorized
colorises = colorizes
colorising = colorizing
colorless = colourless
colors = colours
colpocoele = colpocele
colpocystocoele = colpocystocele
combivir = Combivir
commercialisation = commercialization
commercialise = commercialize
commercialised = commercialized
commercialises = commercializes
commercialising = commercializing
communalise = communalize
communalised = communalized
communalises = communalizes
communalising = communalizing
communisation = communization
communise = communize
communised = communized
communises = communizes
communising = communizing
comorbidities = co-morbidities
compartmentalisation = compartmentalization
compartmentalise = compartmentalize
compartmentalised = compartmentalized
compartmentalises = compartmentalizes
compartmentalising = compartmentalizing
computerisation = computerization
computerise = computerize
computerised = computerized
computerises = computerizes
computerising = computerizing
comtan = Comtan
conceptualisation = conceptualization
conceptualise = conceptualize
conceptualised = conceptualized
conceptualises = conceptualizes
conceptualising = conceptualizing
conceptualizedised = conceptualized
concerta = Concerta
concretisation = concretization
concretise = concretize
concretised = concretized
concretises = concretizes
concretising = concretizing
containerisation = containerization
containerise = containerize
containerised = containerized
containerises = containerizes
containerising = containerizing
contin = Contin
convenia = Convenia
conventionalisation = conventionalization
conventionalise = conventionalize
conventionalised = conventionalized
conventionalises = conventionalizes
conventionalising = conventionalizing
cooperate = co-operate
cooperatively = co-operatively
coordinate = co-ordinate
coordinated = co-ordinated
coordinates = co-ordinates
coordinating = co-ordinating
copaxone = Copaxone
cordstromal = cord-stromal
coreg = Coreg
corepressor = co-repressor
cosecrete = co-secrete
cosopt = Cosopt
costimulatory = co-stimulatory
cotranslational = co-translational
cotransport = co-transport
cotransporter = co-transporter
cotransporters = co-transporters
coumadin = Coumadin
counseled = counselled
counseling = counselling
counselor = counsellor
counselors = counsellors
counterargument = counter-argument
counterregulation = counter-regulation
counterregulatory = counter-regulatory
counterstrike = counter-strike
counterthrust = counter-thrust
coversyl = Coversyl
cozaar = Cozaar
craniocoele = craniocele
creatinaemia = creatinemia
creatinaemic = creatinemic
creatorrhoea = creatorrhea
crestor = Crestor
criminalise = criminalize
criminalised = criminalized
criminalises = criminalizes
criminalising = criminalizing
criticise = criticize
criticised = criticized
criticiser = criticizer
criticisers = criticizers
criticises = criticizes
criticising = criticizing
crixivan = Crixivan
cryoglobulinaemia = cryoglobulinemia
cryoglobulinaemic = cryoglobulinemic
cryptaesthesia = cryptesthesia
crystallisable = crystallizable
crystallisation = crystallization
crystallise = crystallize
crystallised = crystallized
crystalliser = crystallizer
crystallisers = crystallizers
crystallises = crystallizes
crystallising = crystallizing
cubicin = Cubicin
customisable = customizable
customisation = customization
customise = customize
customised = customized
customises = customizes
customising = customizing
cyanmethaemoglobin = cyanmethemoglobin
cyclaseactivating = cyclase-activating
cycledependent = cycle-dependent
cyclen = Cyclen
cyclooxygenase = cyclo-oxygenase
cymbalta = Cymbalta
cystocoele = cystocele
cystourethrocoele = cystourethrocele
cytokinaemia = cytokinemia
cytomel = Cytomel
cytovene = Cytovene
dacryocystocoele = dacryocystocele
dacryorrhoea = dacryorrhea
decentralisation = decentralization
decentralisations = decentralizations
decentralise = decentralize
decentralised = decentralized
decentralises = decentralizes
decentralising = decentralizing
deciliter = decilitre
deciliters = decilitres
decimalisation = decimalization
decimalisations = decimalizations
decolonisation = decolonization
decolonisations = decolonizations
decolonise = decolonize
decolonised = decolonized
decolonises = decolonizes
decolonising = decolonizing
decolorise = decolorize
decolorised = decolorized
decolorises = decolorizes
decolorising = decolorizing
decriminalisation = decriminalization
decriminalise = decriminalize
decriminalised = decriminalized
decriminalises = decriminalizes
decriminalising = decriminalizing
dectomax = Dectomax
dectomaz = Dectomaz
defaecalgesiophobia = defecalgesiophobia
defenses = defences
definity = Definity
deglycerolise = deglycerolize
deglycerolised = deglycerolized
deglycerolises = deglycerolizes
deglycerolising = deglycerolizing
dehumanisation = dehumanization
dehumanise = dehumanize
dehumanised = dehumanized
dehumanises = dehumanizes
dehumanising = dehumanizing
deionisation = deionization
deionise = deionize
deionised = deionized
deionises = deionizes
deionising = deionizing
delocalise = delocalize
delocalised = delocalized
delocalises = delocalizes
delocalising = delocalizing
demadex = Demadex
demagnetisation = demagnetization
demagnetise = demagnetize
demagnetised = demagnetized
demagnetiser = demagnetizer
demagnetisers = demagnetizers
demagnetises = demagnetizes
demagnetising = demagnetizing
dematerialisation = dematerialization
dematerialise = dematerialize
dematerialised = dematerialized
dematerialises = dematerializes
dematerialising = dematerializing
demeanor = demeanour
demerol = Demerol
demilitarisation = demilitarization
demilitarise = demilitarize
demilitarised = demilitarized
demilitarises = demilitarizes
demilitarising = demilitarizing
demineralisation = demineralization
demineralise = demineralize
demineralised = demineralized
demineralises = demineralizes
demineralising = demineralizing
demobilisation = demobilization
demobilisations = demobilizations
demobilise = demobilize
demobilised = demobilized
demobilises = demobilizes
demobilising = demobilizing
democratisation = democratization
democratise = democratize
democratised = democratized
democratises = democratizes
democratising = democratizing
demonetise = demonetize
demonetised = demonetized
demonetises = demonetizes
demonetising = demonetizing
demonise = demonize
demonised = demonized
demonises = demonizes
demonising = demonizing
demoralisation = demoralization
demoralise = demoralize
demoralised = demoralized
demoraliser = demoralizer
demoralisers = demoralizers
demoralises = demoralizes
demoralising = demoralizing
demythologisation = demythologization
demythologise = demythologize
demythologised = demythologized
demythologises = demythologizes
demythologising = demythologizing
denationalisation = denationalization
denationalisations = denationalizations
denationalise = denationalize
denationalised = denationalized
denationalises = denationalizes
denationalising = denationalizing
denaturalisation = denaturalization
denaturalisations = denaturalizations
denaturalise = denaturalize
denaturalised = denaturalized
denaturalises = denaturalizes
denaturalising = denaturalizing
denavir = Denavir
deodorise = deodorize
deodorised = deodorized
deodorises = deodorizes
deodorising = deodorizing
deoxidise = deoxidize
deoxidised = deoxidized
deoxidiser = deoxidizer
deoxidisers = deoxidizers
deoxidises = deoxidizes
deoxidising = deoxidizing
deoxyhaemoglobin = deoxyhemoglobin
departmentalisation = departmentalization
departmentalise = departmentalize
departmentalised = departmentalized
departmentalises = departmentalizes
departmentalising = departmentalizing
dependents = dependants
depersonalisation = depersonalization
depersonalise = depersonalize
depersonalised = depersonalized
depersonalises = depersonalizes
depersonalising = depersonalizing
depolarisation = depolarization
depolarise = depolarize
depolarised = depolarized
depolariser = depolarizer
depolarisers = depolarizers
depolarises = depolarizes
depolarising = depolarizing
depressurisation = depressurization
depressurise = depressurize
depressurised = depressurized
depressurises = depressurizes
depressurising = depressurizing
deputise = deputize
deputised = deputized
deputises = deputizes
deputising = deputizing
derepressed = de-repressed
desalinisation = desalinization
desalinise = desalinize
desalinised = desalinized
desalinises = desalinizes
desalinising = desalinizing
desensitisation = desensitization
desensitise = desensitize
desensitised = desensitized
desensitiser = desensitizer
desensitisers = desensitizers
desensitises = desensitizes
desensitising = desensitizing
desexualise = desexualize
desexualised = desexualized
desexualises = desexualizes
desexualising = desexualizing
despotise = despotize
despotised = despotized
despotises = despotizes
despotising = despotizing
destabilisation = destabilization
destabilise = destabilize
destabilised = destabilized
destabilises = destabilizes
destabilising = destabilizing
desynchronise = desynchronize
desynchronised = desynchronized
desynchronises = desynchronizes
desynchronising = desynchronizing
detribalise = detribalize
detribalised = detribalized
detribalises = detribalizes
detribalising = detribalizing
detrol = Detrol
devitalise = devitalize
devitalised = devitalized
devitalises = devitalizes
devitalising = devitalizing
devitalizedised = devitalized
diacetaemia = diacetemia
diacetaemic = diacetemic
diagonalisable = diagonalizable
diamicron = Diamicron
diaphragmatocoele = diaphragmatocele
diarrhoea = diarrhea
diarrhoeaic = diarrheaic
diarrhoeal = diarrheal
diarrhoeas = diarrheas
dichotomisation = dichotomization
dichotomise = dichotomize
dichotomised = dichotomized
dichotomises = dichotomizes
dichotomising = dichotomizing
diclectin = Diclectin
diethylenetriaminepentaacetic = diethylene-triamine-penta-acetic
digitalisation = digitalization
digitalise = digitalize
digitalised = digitalized
digitalises = digitalizes
digitalising = digitalizing
digitisation = digitization
digitise = digitize
digitised = digitized
digitiser = digitizer
digitisers = digitizers
digitises = digitizes
digitising = digitizing
dihydroxymandelic = dihydroxy-mandelic
dihydroxyphenylalanine = dihydroxy-phenylalanine
dilaudid = Dilaudid
diovan = Diovan
diplococcaemia = diplococcemia
diplococcaemic = diplococcemic
diprivan = Diprivan
disalcid = Disalcid
disfavor = disfavour
dishonor = dishonour
dishonorable = dishonourable
dishonored = dishonoured
dishonoring = dishonouring
dishonors = dishonours
disorganisation = disorganization
disorganise = disorganize
disorganised = disorganized
disorganises = disorganizes
disorganising = disorganizing
distills = distils
doglike = dog-like
dogmatise = dogmatize
dogmatised = dogmatized
dogmatises = dogmatizes
dogmatising = dogmatizing
dostinex = Dostinex
dovobet = Dovobet
dovonex = Dovonex
downgraded = down-graded
dramatisation = dramatization
dramatise = dramatize
dramatised = dramatized
dramatises = dramatizes
dramatising = dramatizing
dreamlike = dream-like
duodopa = Duodopa
dysaemia = dysemia
dysaemic = dysemic
dysaesthesia = dysesthesia
dysaesthetic = dysesthetic
dysalbuminaemic = dysalbuminemic
dysbetalipoproteinaemia = dysbetalipoproteinemia
dysbetalipoproteinaemic = dysbetalipoproteinemic
dysfibrinogenaemia = dysfibrinogenemia
dysgammaglobulinaemia = dysgammaglobulinemia
dysgammaglobulinaemic = dysgammaglobulinemic
dysglobulinaemia = dysglobulinemia
dysglobulinaemic = dysglobulinemic
dyslipidaemia = dyslipidemia
dyslipidaemic = dyslipidemic
dysmenorrhoea = dysmenorrhea
dysphaemia = dysphemia
dysphaemic = dysphemic
dyspnoea = dyspnea
dyspnoeic = dyspneic
earlyforming = early-forming
earthborn = earth-born
ebixa = Ebixa
ebonise = ebonize
ebonised = ebonized
ebonises = ebonizes
ebonising = ebonizing
economise = economize
economised = economized
economiser = economizer
economisers = economizers
economises = economizes
economising = economizing
editorialise = editorialize
editorialised = editorialized
editorialises = editorializes
editorialising = editorializing
effeminise = effeminize
effeminised = effeminized
effeminises = effeminizes
effeminising = effeminizing
effexor = Effexor
eightfold = eight-fold
elidel = Elidel
eligard = Eligard
elocom = Elocom
emblematise = emblematize
emend = Emend
emotionalise = emotionalize
emotionalised = emotionalized
emotionalises = emotionalizes
emotionalising = emotionalizing
empathise = empathize
empathised = empathized
empathises = empathizes
empathising = empathizing
emphasise = emphasize
emphasised = emphasized
emphasises = emphasizes
emphasising = emphasizing
emtriva = Emtriva
enablex = Enablex
enamor = enamour
enamored = enamoured
enamoring = enamouring
enamors = enamours
enbrel = Enbrel
encephalocoele = encephalocele
encephalocoeles = encephaloceles
encephalomeningocoele = encephalomeningocele
encyclopaedia = encyclopedia
encyclopaedias = encyclopedias
encyclopaedic = encyclopedic
endeavor = endeavour
endeavored = endeavoured
endeavoring = endeavouring
endeavors = endeavours
endobrachyoesophagus = endobrachyesophagus
endorphincontaining = endorphin-containing
endorphinlike = endorphin-like
endotoxaemia = endotoxemia
endotoxaemic = endotoxemic
energise = energize
energised = energized
energiser = energizer
energisers = energizers
energises = energizes
energising = energizing
enroll = enrol
enrollment = enrolment
enrolls = enrols
enterochromaffinlike = enterochromaffin-like
enterocoele = enterocele
enterocystocoele = enterocystocele
enteroepiplocoele = enteroepiplocele
enterohaemorrhagic = enterohemorrhagic
enterohydrocoele = enterohydrocele
enthrall = enthral
enthralls = enthrals
entocort = Entocort
epicenter = epicentre
epicenters = epicentres
epigastrocoele = epigastrocele
epigrammatise = epigrammatize
epigrammatised = epigrammatized
epigrammatises = epigrammatizes
epigrammatising = epigrammatizing
epinephrinaemia = epinephrinemia
epinephrinaemic = epinephrinemic
epiplomphalocoele = epiplomphalocele
epiplosarcomphalocoele = epiplosarcomphalocele
epitomise = epitomize
epitomised = epitomized
epitomises = epitomizes
epitomising = epitomizing
epival = Epival
equalisation = equalization
equalise = equalize
equalised = equalized
equaliser = equalizer
equalisers = equalizers
equalises = equalizes
equalising = equalizing
eraxis = Eraxis
erbitux = Erbitux
erythaemia = erythemia
erythaemic = erythemic
erythraemia = erythremia
erythraemic = erythremic
erythroleukaemia = erythroleukemia
erythroleukaemic = erythroleukemic
estalis = Estalis
estradot = Estradot
estrogel = Estrogel
eternalise = eternalize
eternalised = eternalized
eternalises = eternalizes
eternalising = eternalizing
eternise = eternize
eternised = eternized
eternises = eternizes
eternising = eternizing
etherealise = etherealize
etherealised = etherealized
etherealises = etherealizes
etherealising = etherealizing
etherise = etherize
etherised = etherized
etherises = etherizes
etherising = etherizing
ethyol = Ethyol
etopophos = Etopophos
etymologise = etymologize
etymologised = etymologized
etymologises = etymologizes
etymologising = etymologizing
eucalcaemic = eucalcemic
euglycaemia = euglycemia
euglycaemic = euglycemic
eulogise = eulogize
eulogised = eulogized
eulogiser = eulogizer
eulogisers = eulogizers
eulogises = eulogizes
eulogising = eulogizing
euphemise = euphemize
euphemised = euphemized
euphemises = euphemizes
euphemising = euphemizing
eupnoea = eupnea
euvolaemic = euvolemic
evangelisation = evangelization
evangelise = evangelize
evangelised = evangelized
evangelises = evangelizes
evangelising = evangelizing
evista = Evista
evra = Evra
exelon = Exelon
exjade = Exjade
exorcise = exorcize
exorcised = exorcized
exorcises = exorcizes
exorcising = exorcizing
extemporisation = extemporization
extemporise = extemporize
extemporised = extemporized
extemporises = extemporizes
extemporising = extemporizing
exteriorisation = exteriorization
exteriorise = exteriorize
exteriorised = exteriorized
exteriorises = exteriorizes
exteriorising = exteriorizing
externalisation = externalization
externalise = externalize
externalised = externalized
externalises = externalizes
externalising = externalizing
extracellular = extra-cellular
extraovarian = extra-ovarian
extrauterine = extra-uterine
exubera = Exubera
ezetrol = Ezetrol
factive = Factive
factorisation = factorization
factorise = factorize
factorised = factorized
factorises = factorizes
factorising = factorizing
faecal = fecal
faecalith = fecalith
faecaliths = fecaliths
faeces = feces
familiarisation = familiarization
familiarise = familiarize
familiarised = familiarized
familiarises = familiarizes
familiarising = familiarizing
famvir = Famvir
fanaticise = fanaticize
fanaticised = fanaticized
fanaticises = fanaticizes
fanaticising = fanaticizing
fantasise = fantasize
fantasised = fantasized
fantasises = fantasizes
fantasising = fantasizing
faradise = faradize
faradised = faradized
faradises = faradizes
faradising = faradizing
fasturtec = Fasturtec
favor = favour
favorable = favourable
favorably = favourably
favored = favoured
favoring = favouring
favorite = favourite
favorites = favourites
favoritism = favouritism
favors = favours
federalisation = federalization
federalise = federalize
federalised = federalized
federalises = federalizes
federalising = federalizing
feedforward = feed-forward
femara = Femara
feminisation = feminization
feminise = feminize
feminised = feminized
feminises = feminizes
feminising = feminizing
feminizingising = feminizing
fertilisable = fertilizable
fertilisation = fertilization
fertilise = fertilize
fertilised = fertilized
fertiliser = fertilizer
fertilisers = fertilizers
fertilises = fertilizes
fertilising = fertilizing
fertinorm = Fertinorm
fervor = fervour
feudalise = feudalize
feudalised = feudalized
feudalises = feudalizes
feudalising = feudalizing
fiber = fibre
fiberglass = fibreglass
fiberoptic = fibreoptic
fibers = fibres
fibreoptic = fibre-optic
fictionalisation = fictionalization
fictionalise = fictionalize
fictionalised = fictionalized
fictionalises = fictionalizes
fictionalising = fictionalizing
finacea = Finacea
finalisation = finalization
finalise = finalize
finalised = finalized
finalises = finalizes
finalising = finalizing
fingerlike = finger-like
fivefold = five-fold
flasklike = flask-like
flomax = Flomax
flovent = Flovent
fluidisation = fluidization
fluidise = fluidize
fluidised = fluidized
fluidises = fluidizes
fluidising = fluidizing
flulike = flu-like
focalisation = focalization
focalise = focalize
focalised = focalized
focalises = focalizes
focalising = focalizing
foetal = fetal
foetomaternal = fetomaternal
foetometry = fetometry
foetoprotein = fetoprotein
foetoscope = fetoscope
foetus = fetus
foetuses = fetuses
folliclestimulating = follicle-stimulating
formalisation = formalization
formalise = formalize
formalised = formalized
formaliser = formalizer
formalisers = formalizers
formalises = formalizes
formalising = formalizing
formularise = formularize
formularised = formularized
formularises = formularizes
formularising = formularizing
formulise = formulize
formulised = formulized
formulises = formulizes
formulising = formulizing
forteo = Forteo
fortovase = Fortovase
fosamax = Fosamax
fosavance = Fosavance
fosrenol = Fosrenol
fossilisation = fossilization
fossilise = fossilize
fossilised = fossilized
fossilises = fossilizes
fossilising = fossilizing
fourfold = four-fold
fractionalisation = fractionalization
fractionalise = fractionalize
fractionalised = fractionalized
fractionalises = fractionalizes
fractionalising = fractionalizing
fragmentise = fragmentize
fragmentised = fragmentized
fragmentises = fragmentizes
fragmentising = fragmentizing
fraternisation = fraternization
fraternise = fraternize
fraternised = fraternized
fraterniser = fraternizer
fraternisers = fraternizers
fraternises = fraternizes
fraternising = fraternizing
froglike = frog-like
frostbitten = frost-bitten
frova = Frova
fructosaemia = fructosemia
fructosaemic = fructosemic
fueled = fuelled
fueling = fuelling
fulfill = fulfil
fungaemia = fungemia
fungaemic = fungemic
funneled = funnelled
funneling = funnelling
furor = furore
galactocoele = galactocele
galactorrhoea = galactorrhea
galactosaemia = galactosemia
galactosaemic = galactosemic
galvanisation = galvanization
galvanise = galvanize
galvanised = galvanized
galvaniser = galvanizer
galvanisers = galvanizers
galvanises = galvanizes
galvanising = galvanizing
gastrocoele = gastrocele
gastrogard = Gastrogard
gastrooesophageal = gastroesophageal
gelatinise = gelatinize
gelatinised = gelatinized
gelatinises = gelatinizes
gelatinising = gelatinizing
generalisation = generalization
generalise = generalize
generalised = generalized
generalises = generalizes
generalising = generalizing
generelated = gene-related
geologise = geologize
geologised = geologized
geologises = geologizes
geologising = geologizing
geometrise = geometrize
geometrised = geometrized
geometrises = geometrizes
geometrising = geometrizing
germanise = germanize
germanised = germanized
germanises = germanizes
germanising = germanizing
germfree = germ-free
ghettoise = ghettoize
ghettoised = ghettoized
ghettoises = ghettoizes
ghettoising = ghettoizing
gigaliter = gigalitre
gigaliters = gigalitres
glamorisation = glamorization
glamorise = glamorize
glamorised = glamorized
glamorises = glamorizes
glamorising = glamorizing
gleevec = Gleevec
globalisation = globalization
globalise = globalize
globalised = globalized
globalises = globalizes
globalising = globalizing
glossocoele = glossocele
glucagonlike = glucagon-like
glucocorticoidenhanced = glucocorticoid-enhanced
glucocorticoidlike = glucocorticoid-like
glucohaemia = glucohemia
glucohaemic = glucohemic
gluconorm = Gluconorm
glucoselowering = glucose-lowering
glucotrol = Glucotrol
glumetza = Glumetza
glycaemia = glycemia
glycaemic = glycemic
glycerolise = glycerolize
glycerolised = glycerolized
glycerolises = glycerolizes
glycerolising = glycerolizing
glycohaemoglobin = glycohemoglobin
glycosaemia = glycosemia
glycosaemic = glycosemic
godlike = god-like
goiter = goitre
goiters = goitres
gonadotropin = gonadotrophin
gonadotropins = gonadotrophins
gonococcaemia = gonococcemia
gonococcaemic = gonococcemic
gonohaemia = gonohemia
gonohaemic = gonohemic
gonorrhoea = gonorrhea
gonorrhoeae = gonorrheae
gonorrhoeal = gonorrheal
gonyocoele = gonyocele
gormandize = gourmandize
gourmandise = gourmandize
gourmandised = gourmandized
gourmandises = gourmandizes
gourmandising = gourmandizing
granulise = granulize
granulised = granulized
granulises = granulizes
granulising = granulizing
grapelike = grape-like
graphaesthesia = graphesthesia
graphitise = graphitize
graphitised = graphitized
graphitises = graphitizes
graphitising = graphitizing
graying = greying
grueling = gruelling
gynaecogenic = gynecogenic
gynaecography = gynecography
gynaecoid = gynecoid
gynaecologic = gynecologic
gynaecological = gynecological
gynaecologist = gynecologist
gynaecologists = gynecologists
gynaecology = gynecology
gynaecomania = gynecomania
gynaecomastia = gynecomastia
gyrostabiliser = gyrostabilizer
gyrostabilisers = gyrostabilizers
haem = heme
haemachrosis = hemachrosis
haemagglutination = hemagglutination
haemagglutinin = hemagglutinin
haemaglobinuria = hemaglobinuria
haemangioblastoma = hemangioblastoma
haemangioblastomas = hemangioblastomas
haemangioblastomatosis = hemangioblastomatosis
haemangioendothelioma = hemangioendothelioma
haemangioendotheliomas = hemangioendotheliomas
haemangioma = hemangioma
haemangiomas = hemangiomas
haemangiomathrombocytopenia = hemangiomathrombocytopenia
haemangiomatoses = hemangiomatoses
haemangiomatosis = hemangiomatosis
haemangiopericytoma = hemangiopericytoma
haemangiosarcoma = hemangiosarcoma
haemapoiesis = hemapoiesis
haemarthroses = hemarthroses
haemarthrosis = hemarthrosis
haemartomatosis = hemartomatosis
haematapostema = hematapostema
haematemesis = hematemesis
haemathidrosis = hemathidrosis
haematic = hematic
haematidrosis = hematidrosis
haematinic = hematinic
haematinics = hematinics
haematinuria = hematinuria
haematite = hematite
haematobilia = hematobilia
haematobium = hematobium
haematocelia = hematocelia
haematocephalus = hematocephalus
haematochezia = hematochezia
haematochromatosis = hematochromatosis
haematocoele = hematocele
haematocolpos = hematocolpos
haematocrit = hematocrit
haematocrits = hematocrits
haematocyturia = hematocyturia
haematogenesis = hematogenesis
haematogenetic = hematogenetic
haematogenous = hematogenous
haematogenously = hematogenously
haematoid = hematoid
haematologic = hematologic
haematological = hematological
haematologically = hematologically
haematologist = hematologist
haematologists = hematologists
haematology = hematology
haematoma = hematoma
haematomas = hematomas
haematomata = hematomata
haematomediastinum = hematomediastinum
haematomegaly = hematomegaly
haematometra = hematometra
haematomyelia = hematomyelia
haematonephrosis = hematonephrosis
haematopathologist = hematopathologist
haematopericardium = hematopericardium
haematoperitoneum = hematoperitoneum
haematoplastic = hematoplastic
haematopoiesis = hematopoiesis
haematopoietic = hematopoietic
haematorrhachis = hematorrhachis
haematorrhea = hematorrhea
haematosalpinx = hematosalpinx
haematosepsis = hematosepsis
haematothorax = hematothorax
haematotympanum = hematotympanum
haematozoon = hematozoon
haematuria = hematuria
haemeralopia = hemeralopia
haemic = hemic
haemobilia = hemobilia
haemoblobin = hemoblobin
haemoccult = hemoccult
haemochromatosis = hemochromatosis
haemoclasia = hemoclasia
haemoclasis = hemoclasis
haemoconcentration = hemoconcentration
haemocyte = hemocyte
haemocytes = hemocytes
haemodialyser = hemodialyser
haemodialysis = hemodialysis
haemodilution = hemodilution
haemodynamic = hemodynamic
haemodynamically = hemodynamically
haemodynamics = hemodynamics
haemofiltration = hemofiltration
haemoglobin = hemoglobin
haemoglobinaemia = hemoglobinemia
haemoglobinaemic = hemoglobinemic
haemoglobinopathies = hemoglobinopathies
haemoglobinopathy = hemoglobinopathy
haemoglobins = hemoglobins
haemoglobinuria = hemoglobinuria
haemolyse = hemolyse
haemolysin = hemolysin
haemolysing = hemolysing
haemolysis = hemolysis
haemolytic = hemolytic
haemonephrosis = hemonephrosis
haemopathology = hemopathology
haemoperfusion = hemoperfusion
haemopericardium = hemopericardium
haemoperitoneum = hemoperitoneum
haemophagocytic = hemophagocytic
haemophilia = hemophilia
haemophiliac = hemophiliac
haemophiliacs = hemophiliacs
haemophilic = hemophilic
haemophilus = hemophilus
haemophthalmia = hemophthalmia
haemophthalmus = hemophthalmus
haemopleura = hemopleura
haemopneumopericardium = hemopneumopericardium
haemopneumothorax = hemopneumothorax
haemopoiesis = hemopoiesis
haemopoietic = hemopoietic
haemoptyses = hemoptyses
haemoptysis = hemoptysis
haemorrhage = hemorrhage
haemorrhages = hemorrhages
haemorrhagic = hemorrhagic
haemorrhagica = hemorrhagica
haemorrhaging = hemorrhaging
haemorrhoid = hemorrhoid
haemorrhoidal = hemorrhoidal
haemorrhoidectomy = hemorrhoidectomy
haemorrhoids = hemorrhoids
haemosalpinx = hemosalpinx
haemosiderin = hemosiderin
haemosiderosis = hemosiderosis
haemostasia = hemostasia
haemostasis = hemostasis
haemostat = hemostat
haemostatic = hemostatic
haemostats = hemostats
haemothorax = hemothorax
haemothymia = hemothymia
haemotympanum = hemotympanum
hairlike = hair-like
halflife = half-life
haploinsufficiency = haplo-insufficiency
haploinsufficient = haplo-insufficient
harbor = harbour
harbored = harboured
harboring = harbouring
harbors = harbours
harddrive = hard drive
hardhearted = hard-hearted
harmonisation = harmonization
harmonise = harmonize
harmonised = harmonized
harmoniser = harmonizer
harmonisers = harmonizers
harmonises = harmonizes
harmonising = harmonizing
heathenise = heathenize
heathenised = heathenized
heathenises = heathenizes
heathenising = heathenizing
hedrocoele = hedrocele
helixate = Helixate
hemihyperaesthesia = hemihyperesthesia
hemiparaesthesia = hemiparesthesia
hemiparalysis = hemi-paralysis
hemithyroid = hemi-thyroid
hemithyroidectomy = hemi-thyroidectomy
hemolyze = hemolyse
hemolyzed = haemolysed
hemolyzing = hemolysing
heparinizedised = heparinized
hepatohaemia = hepatohemia
hepatohaemic = hepatohemic
hepsera = Hepsera
heptovir = Heptovir
herceptin = Herceptin
heterophaemia = heterophemia
heterophaemic = heterophemic
hextend = Hextend
highdose = high-dose
highfat = high-fat
highstrung = high-strung
histaminaemia = histaminemia
histaminaemic = histaminemic
histidinaemia = histidinemia
histidinaemic = histidinemic
historicise = historicize
historicised = historicized
historicises = historicizes
historicising = historicizing
hivid = Hivid
homaeopathic = homeopathic
homoeopath = homeopath
homoeopathy = homeopathy
homogenisation = homogenization
homogenise = homogenize
homogenised = homogenized
homogeniser = homogenizer
homogenisers = homogenizers
homogenises = homogenizes
homogenising = homogenizing
honor = honour
honored = honoured
honoring = honouring
honors = honours
hormonebinding = hormone-binding
hormonecontaining = hormone-containing
hormonedeficient = hormone-deficient
hormonedependent = hormone-dependent
hormonedirected = hormone-directed
hormoneindependent = hormone-independent
hormoneinduced = hormone-induced
hormonelike = hormone-like
hormoneproducing = hormone-producing
hormoneregulated = hormone-regulated
hormonerelated = hormone-related
hormonesecreting = hormone-secreting
hormonetreated = hormone-treated
hospitalisation = hospitalization
hospitalise = hospitalize
hospitalised = hospitalized
hospitalises = hospitalizes
hospitalising = hospitalizing
hospitalizedised = hospitalized
humaject = Humaject
humalog = Humalog
humanisation = humanization
humanise = humanize
humanised = humanized
humaniser = humanizer
humanisers = humanizers
humanises = humanizes
humanising = humanizing
humanlike = human-like
humira = Humira
humor = humour
humored = humoured
humoring = humouring
humorless = humourless
humors = humours
hyalinisation = hyalinization
hybridisation = hybridization
hybridise = hybridize
hybridised = hybridized
hybridiser = hybridizer
hybridisers = hybridizers
hybridises = hybridizes
hybridising = hybridizing
hybridizationisation = hybridization
hycamtin = Hycamtin
hydrencephalocoele = hydrencephalocele
hydrocoele = hydrocele
hydrocoelectomy = hydrocelectomy
hydrocoeles = hydroceles
hydroencephalocoele = hydroencephalocele
hydroencephalomeningocoele = hydroencephalomeningocele
hydrolyze = hydrolyse
hydrolyzed = hydrolysed
hydrolyzes = hydrolyses
hydrolyzing = hydrolysing
hydromeningocoele = hydromeningocele
hydromorph = Hydromorph
hydromyelocoele = hydromyelocele
hydromyelomeningocoele = hydromyelomeningocele
hydrorrhoea = hydrorrhea
hydrothioammonaemia = hydrothioammonemia
hydrothioammonaemic = hydrothioammonemic
hydrothionaemia = hydrothionemia
hydrothionaemic = hydrothionemic
hydroxylasedeficient = hydroxylase-deficient
hydroxysteroid = hydroxy-steroid
hydroxyvitamin = hydroxy-vitamin
hypaesthesia = hypesthesia
hyperaaesthesia = hyperaesthesia
hyperaemia = hyperemia
hyperaemic = hyperemic
hyperaesthesia = hyperesthesia
hyperalbuminaemia = hyperalbuminemia
hyperalbuminaemic = hyperalbuminemic
hyperaminoacidaemia = hyperaminoacidemia
hyperaminoacidaemic = hyperaminoacidemic
hyperammonaemia = hyperammonemia
hyperammonaemic = hyperammonemic
hyperamylasaemia = hyperamylasemia
hyperamylasaemic = hyperamylasemic
hyperazotaemia = hyperazotemia
hyperazotaemic = hyperazotemic
hyperbetalipoproteinaemia = hyperbetalipoproteinemia
hyperbetalipoproteinaemic = hyperbetalipoproteinemic
hyperbilirubinaemia = hyperbilirubinemia
hyperbilirubinaemic = hyperbilirubinemic
hyperbolise = hyperbolize
hyperbolised = hyperbolized
hyperbolises = hyperbolizes
hyperbolising = hyperbolizing
hypercalcaemia = hypercalcemia
hypercalcaemias = hypercalcemias
hypercalcaemic = hypercalcemic
hypercalcitoninaemia = hypercalcitoninemia
hyperchloraemia = hyperchloremia
hyperchloraemic = hyperchloremic
hypercholesterolaemia = hypercholesterolemia
hypercholesterolaemic = hypercholesterolemic
hyperchylomicronaemia = hyperchylomicronemia
hyperchylomicronaemic = hyperchylomicronemic
hypercortisolaemia = hypercortisolemia
hypercriticise = hypercriticize
hypercriticised = hypercriticized
hypercriticises = hypercriticizes
hypercriticising = hypercriticizing
hypercupraemia = hypercupremia
hypercupraemic = hypercupremic
hypercythaemia = hypercythemia
hypercythaemic = hypercythemic
hyperepinephrinaemia = hyperepinephrinemia
hyperepinephrinaemic = hyperepinephrinemic
hyperferraemia = hyperferremia
hyperferraemic = hyperferremic
hyperfibrinogenaemia = hyperfibrinogenemia
hyperfibrinogenaemic = hyperfibrinogenemic
hypergammaglobulinaemia = hypergammaglobulinemia
hypergammaglobulinaemic = hypergammaglobulinemic
hypergastrinaemia = hypergastrinemia
hypergastrinaemic = hypergastrinemic
hypergeusaesthesia = hypergeusesthesia
hyperglobulinaemia = hyperglobulinemia
hyperglobulinaemic = hyperglobulinemic
hyperglucagonaemia = hyperglucagonemia
hyperglycaemia = hyperglycemia
hyperglycaemic = hyperglycemic
hyperglycinaemia = hyperglycinemia
hyperglycinaemic = hyperglycinemic
hyperglycosaemia = hyperglycosemia
hyperglycosaemic = hyperglycosemic
hyperhomocysteinaemia = hyperhomocysteinemia
hyperinosaemia = hyperinosemia
hyperinosaemic = hyperinosemic
hyperinsulinaemia = hyperinsulinemia
hyperinsulinaemic = hyperinsulinemic
hyperkalaemia = hyperkalemia
hyperkalaemic = hyperkalemic
hyperkaliaemia = hyperkaliemia
hyperkaliaemic = hyperkaliemic
hyperlipidaemia = hyperlipidemia
hyperlipidaemias = hyperlipidemias
hyperlipidaemic = hyperlipidemic
hyperlipoproteinaemia = hyperlipoproteinemia
hyperlipoproteinaemic = hyperlipoproteinemic
hypermagnesaemia = hypermagnesemia
hypermagnesaemic = hypermagnesemic
hypermenorrhoea = hypermenorrhea
hypernatraemia = hypernatremia
hypernatraemic = hypernatremic
hyperparacalcaemia = hyperparacalcemia
hyperparacalcaemic = hyperparacalcemic
hyperphenylalaninaemia = hyperphenylalaninemia
hyperphosphataemia = hyperphosphatemia
hyperphosphataemic = hyperphosphatemic
hyperphosphatasaemia = hyperphosphatasemia
hyperphosphatasaemic = hyperphosphatasemic
hyperphospheraemia = hyperphospheremia
hyperphospheraemic = hyperphospheremic
hyperpnoea = hyperpnea
hyperpotassaemia = hyperpotassemia
hyperpotassaemic = hyperpotassemic
hyperprolactinaemia = hyperprolactinemia
hyperprolactinaemic = hyperprolactinemic
hyperprolatinaemia = hyperprolatinemia
hyperproteinaemia = hyperproteinemia
hyperproteinaemic = hyperproteinemic
hypersecreted = hyper-secreted
hyperthrombinaemia = hyperthrombinemia
hyperthrombinaemic = hyperthrombinemic
hyperthyroxinaemia = hyperthyroxinemia
hyperthyroxinaemic = hyperthyroxinemic
hypertriglyceraemia = hypertriglyceremia
hypertriglyceraemic = hypertriglyceremic
hypertriglyceridaemia = hypertriglyceridemia
hypertriglyceridaemic = hypertriglyceridemic
hyperuricaemia = hyperuricemia
hyperuricaemic = hyperuricemic
hyperuricaemics = hyperuricemics
hypervalinaemia = hypervalinemia
hypervalinaemic = hypervalinemic
hypervolaemia = hypervolemia
hypervolaemic = hypervolemic
hyphaema = hyphema
hypnoanaesthesia = hypnoanesthesia
hypnotisable = hypnotizable
hypnotise = hypnotize
hypnotised = hypnotized
hypnotises = hypnotizes
hypnotising = hypnotizing
hypoalbuminaemia = hypoalbuminemia
hypoalbuminaemic = hypoalbuminemic
hypoalphalipoproteinaemia = hypo-alpha-lipoproteinaemia
hypoanaesthesia = hypoanesthesia
hypobetalipoproteinaemia = hypobetalipoproteinemia
hypobetalipoproteinaemic = hypobetalipoproteinemic
hypocalcaemia = hypocalcemia
hypocalcaemic = hypocalcemic
hypochloraemia = hypochloremia
hypochloraemic = hypochloremic
hypocholesteraemia = hypocholesteremia
hypocholesteraemic = hypocholesteremic
hypocomplementaemia = hypocomplementemia
hypocomplementaemic = hypocomplementemic
hypocupraemia = hypocupremia
hypocupraemic = hypocupremic
hypocythaemia = hypocythemia
hypocythaemic = hypocythemic
hypoestrogenic = hypo-oestrogenic
hypoferraemia = hypoferremia
hypoferraemic = hypoferremic
hypofibrinogenaemia = hypofibrinogenemia
hypofibrinogenaemic = hypofibrinogenemic
hypogammaglobulinaemia = hypogammaglobulinemia
hypogammaglobulinaemic = hypogammaglobulinemic
hypoglycaemia = hypoglycemia
hypoglycaemias = hypoglycemias
hypoglycaemic = hypoglycemic
hypoinosaemia = hypoinosemia
hypoinosaemic = hypoinosemic
hypoinsulinaemia = hypo-insulinaemia
hypokalaemia = hypokalemia
hypokalaemic = hypokalemic
hypoketonaemic = hypoketonemic
hypoleptinaemia = hypoleptinemia
hypolipidaemia = hypolipidemia
hypolipidaemic = hypolipidemic
hypomagnesaemia = hypomagnesemia
hypomagnesaemic = hypomagnesemic
hyponatraemia = hyponatremia
hyponatraemic = hyponatremic
hypopallaesthesia = hypopallesthesia
hypophosphataemia = hypophosphatemia
hypophosphataemic = hypophosphatemic
hypopnoea = hypopnea
hypopotassaemia = hypopotassemia
hypopotassaemic = hypopotassemic
hypoproteinaemia = hypoproteinemia
hypoproteinaemic = hypoproteinemic
hypoprothrombinaemia = hypoprothrombinemia
hypoprothrombinaemic = hypoprothrombinemic
hyporeninaemic = hyporeninemic
hypostatisation = hypostatization
hypothesise = hypothesize
hypothesised = hypothesized
hypothesiser = hypothesizer
hypothesisers = hypothesizers
hypothesises = hypothesizes
hypothesising = hypothesizing
hypothrombinaemia = hypothrombinemia
hypothrombinaemic = hypothrombinemic
hypothyroxinaemia = hypothyroxinemia
hypothyroxinaemic = hypothyroxinemic
hypovolaemia = hypovolemia
hypovolaemic = hypovolemic
hypoxaemia = hypoxemia
hypoxaemic = hypoxemic
hyzaar = Hyzaar
ichthyohaemotoxism = ichthyohemotoxism
icteroanaemia = icteroanemia
icteroanaemic = icteroanemic
idealisation = idealization
idealise = idealize
idealised = idealized
idealiser = idealizer
idealisers = idealizers
idealises = idealizes
idealising = idealizing
idolisation = idolization
idolise = idolize
idolised = idolized
idoliser = idolizer
idolisers = idolizers
idolises = idolizes
idolising = idolizing
ileocaecal = ileocecal
imitrex = Imitrex
immaterialise = immaterialize
immaterialised = immaterialized
immaterialises = immaterializes
immaterialising = immaterializing
immiticide = Immiticide
immobilisation = immobilization
immobilise = immobilize
immobilised = immobilized
immobilises = immobilizes
immobilising = immobilizing
immortalisation = immortalization
immortalise = immortalize
immortalised = immortalized
immortaliser = immortalizer
immortalisers = immortalizers
immortalises = immortalizes
immortalising = immortalizing
immunisation = immunization
immunise = immunize
immunised = immunized
immunises = immunizes
immunising = immunizing
immunocompromised = immuno-compromised
immunohistochemical = immuno-histochemical
immunopositive = immuno-positive
immunopositivity = immuno-positivity
immunoprecipitable = immuno-precipitable
immunostain = immuno-stain
immunostaining = immuno-staining
immunosuppressive = immuno-suppressive
immunotherapeutic = immuno-therapeutic
imodium = Imodium
impersonalise = impersonalize
impersonalised = impersonalized
impersonalises = impersonalizes
impersonalising = impersonalizing
incognisance = incognizance
incognisant = incognizant
individualisation = individualization
individualise = individualize
individualised = individualized
individualises = individualizes
individualising = individualizing
industrialisation = industrialization
industrialise = industrialize
industrialised = industrialized
industrialises = industrializes
industrialising = industrializing
infergen = Infergen
initialisation = initialization
initialise = initialize
initialised = initialized
initialises = initializes
initialising = initializing
inomax = Inomax
installment = instalment
installments = instalments
instills = instils
institutionalisation = institutionalization
institutionalise = institutionalize
institutionalised = institutionalized
institutionalises = institutionalizes
institutionalising = institutionalizing
insulinaemia = insulinemia
insulinaemic = insulinemic
insulinlike = insulin-like
integrilin = Integrilin
intelence = Intelence
intellectualisation = intellectualization
intellectualise = intellectualize
intellectualised = intellectualized
intellectualises = intellectualizes
intellectualising = intellectualizing
interiorise = interiorize
interiorised = interiorized
interiorises = interiorizes
interiorising = interiorizing
internalisation = internalization
internalise = internalize
internalised = internalized
internalises = internalizes
internalising = internalizing
internalizedised = internalized
internationalisation = internationalization
internationalise = internationalize
internationalised = internationalized
internationalises = internationalizes
internationalising = internationalizing
intersexuality = inter-sexuality
intraassay = intra-assay
intracerebroventricular = intra-cerebroventricular
intraislet = intra-islet
intraocular = intra-ocular
intraoperatively = intra-operatively
intraorbital = intra-orbital
intrapituitary = intra-pituitary
invega = Invega
invirase = Invirase
iodise = iodize
iodised = iodized
iodises = iodizes
iodising = iodizing
ionisable = ionizable
ionisation = ionization
ionise = ionize
ionised = ionized
ioniser = ionizer
ionisers = ionizers
ionises = ionizes
ionising = ionizing
iressa = Iressa
iridaemia = iridemia
iridaemic = iridemic
irideraemia = irideremia
irideraemic = irideremic
iriditis = iritis
ischaemia = ischemia
ischaemic = ischemic
isentress = Isentress
isoimmunizationisation = isoimmunization
italicisation = italicization
italicise = italicize
italicised = italicized
italicises = italicizes
italicising = italicizing
itemisation = itemization
itemise = itemize
itemised = itemized
itemises = itemizes
itemising = itemizing
ivomec = Ivomec
januvia = Januvia
jargonise = jargonize
jargonised = jargonized
jargonises = jargonizes
jargonising = jargonizing
jejunoileal = jejuno-ileal
jeopardise = jeopardize
jeopardised = jeopardized
jeopardises = jeopardizes
jeopardising = jeopardizing
jewelry = jewellery
joi = Joi
journalise = journalize
journalised = journalized
journalises = journalizes
journalising = journalizing
kadian = Kadian
kalaemia = kalemia
kalaemic = kalemic
kaletra = Kaletra
kepivance = Kepivance
keratinizedised = keratinized
keratohaemia = keratohemia
keratohaemic = keratohemic
kerb = curb
kerbs = curbs
ketek = Ketek
ketonaemia = ketonemia
ketonaemic = ketonemic
kilometer = kilometre
kilometers = kilometres
kinaesthesia = kinesthesia
kinanaesthesia = kinanesthesia
kineret = Kineret
kinesiaesthesiometer = kinesiesthesiometer
kivexa = Kivexa
koate = Koate
kogenate = Kogenate
kytril = Kytril
labeled = labelled
labeling = labelling
labialise = labialize
labialised = labialized
labialises = labializes
labialising = labializing
labor = labour
labored = laboured
laborer = labourer
laborers = labourers
laboring = labouring
labors = labours
lactacidaemia = lactacidemia
lactacidaemic = lactacidemic
lacticaemia = lacticemia
lacticaemic = lacticemic
lactocoele = lactocele
lamictal = Lamictal
lamisil = Lamisil
lantus = Lantus
laparocoele = laparocele
laryngocoele = laryngocele
lasix = Lasix
latticework = lattice-work
legalisation = legalization
legalise = legalize
legalised = legalized
legalises = legalizes
legalising = legalizing
legitimatise = legitimatize
legitimatised = legitimatized
legitimatises = legitimatizes
legitimatising = legitimatizing
legitimisation = legitimization
legitimise = legitimize
legitimised = legitimized
legitimises = legitimizes
legitimising = legitimizing
lemmatisation = lemmatization
lemmatise = lemmatize
lemmatised = lemmatized
lemmatises = lemmatizes
lemmatising = lemmatizing
leptospiraemia = leptospiremia
leptospiraemic = leptospiremic
lescol = Lescol
leucorrhoea = leucorrhea
leukaemia = leukemia
leukaemias = leukemias
leukaemic = leukemic
leukaemogenesis = leukemogenesis
leukaemogenic = leukemogenic
leukaemoid = leukemoid
leukaphaeresis = leukapheresis
leukine = Leukine
leukocythaemia = leukocythemia
leukocythaemic = leukocythemic
leukorrhoea = leukorrhea
levaquin = Levaquin
leveled = levelled
leveling = levelling
levemir = Levemir
levitra = Levitra
levovist = Levovist
levulosaemia = levulosemia
levulosaemic = levulosemic
liberalisation = liberalization
liberalise = liberalize
liberalised = liberalized
liberaliser = liberalizer
liberalisers = liberalizers
liberalises = liberalizes
liberalising = liberalizing
licenses = licences
lienocoele = lienocele
lifelike = life-like
lifetime = life-time
ligandbinding = ligand-binding
lionisation = lionization
lionise = lionize
lionised = lionized
lioniser = lionizer
lionisers = lionizers
lionises = lionizes
lionising = lionizing
lipacidaemia = lipacidemia
lipacidaemic = lipacidemic
lipaemia = lipemia
lipaemic = lipemic
lipidaemic = lipidemic
lipidil = Lipidil
lipitor = Lipitor
lipocoele = lipocele
lipoidaemia = lipoidemia
lipoidaemic = lipoidemic
lipomeningocoele = lipomeningocele
lipoproteinaemia = lipoproteinemia
lipoproteinaemic = lipoproteinemic
liquidise = liquidize
liquidised = liquidized
liquidises = liquidizes
liquidising = liquidizing
liter = litre
liters = litres
lithaemia = lithemia
lithaemic = lithemic
liveborn = live-born
lobotomise = lobotomize
lobotomised = lobotomized
lobotomises = lobotomizes
lobotomising = lobotomizing
localisable = localizable
localisation = localization
localise = localize
localised = localized
localiser = localizer
localisers = localizers
localises = localizes
localising = localizing
lochiorrhoea = lochiorrhea
longstanding = long-standing
longterm = long-term
longtime = long-time
lookout = look-out
lorabid = Lorabid
losec = Losec
lotemax = Lotemax
lovenox = Lovenox
lowcarbohydrate = low-carbohydrate
lowdose = low-dose
lowprotein = low-protein
lucentis = Lucentis
lumgan = Lumgan
lumigan = Lumigan
lupron = Lupron
luster = lustre
lymphadenocoele = lymphadenocele
lymphaemia = lymphemia
lymphaemic = lymphemic
lymphocoele = lymphocele
lymphocythaemia = lymphocythemia
lymphocythaemic = lymphocythemic
lymphoedema = lymphedema
lymphorrhoea = lymphorrhea
lyophilise = lyophilize
lyophilised = lyophilized
lyophilises = lyophilizes
lyophilising = lyophilizing
lyrica = Lyrica
mabcampath = Mabcampath
macadamise = macadamize
macadamised = macadamized
macadamises = macadamizes
macadamising = macadamizing
macroaesthesia = macroesthesia
macrocnaemia = macrocnemia
macrocnaemic = macrocnemic
macrocythaemia = macrocythemia
macrocythaemic = macrocythemic
macroglobulinaemia = macroglobulinemia
macroglobulinaemic = macroglobulinemic
macugen = Macugen
magnetisation = magnetization
magnetise = magnetize
magnetised = magnetized
magnetiser = magnetizer
magnetisers = magnetizers
magnetises = magnetizes
magnetising = magnetizing
malarone = Malarone
maneuver = manoeuvre
maneuvered = manoeuvred
maneuvering = manoeuvring
maneuvers = manoeuvres
manyfold = many-fold
marbleise = marbleize
marbleised = marbleized
marbleises = marbleizes
marbleising = marbleizing
marginalise = marginalize
marginalised = marginalized
marginalises = marginalizes
marginalising = marginalizing
marquis = Marquis
martialed = martialled
martialing = martialling
marvelous = marvellous
masculinizationisation = masculinization
materialisation = materialization
materialise = materialize
materialised = materialized
materialises = materializes
materialising = materializing
mavik = Mavik
maxalt = Maxalt
maxiban = Maxiban
maximisation = maximization
maximise = maximize
maximised = maximized
maximises = maximizes
maximising = maximizing
maxipime = Maxipime
mechanisation = mechanization
mechanise = mechanize
mechanised = mechanized
mechanises = mechanizes
mechanising = mechanizing
medipren = Medipren
megaesophagus = mega-oesophagus
megaliter = megalitre
megaliters = megalitres
megalopolise = megalopolize
megalopolised = megalopolized
megalopolises = megalopolizes
megalopolising = megalopolizing
melaena = melena
memorialise = memorialize
memorialised = memorialized
memorialises = memorializes
memorialising = memorializing
memorisation = memorization
memorise = memorize
memorised = memorized
memorises = memorizes
memorising = memorizing
meningococcaemia = meningococcemia
meningococcaemic = meningococcemic
meningocoele = meningocele
meningocoeles = meningoceles
meningoencephalocoele = meningoencephalocele
meningomyelocoele = meningomyelocele
menorrhoea = menorrhea
menostar = Menostar
mepron = Mepron
mercerisation = mercerization
mercerise = mercerize
mercerised = mercerized
mercerises = mercerizes
mercerising = mercerizing
meridia = Meridia
merocoele = merocele
mesmerise = mesmerize
mesmerised = mesmerized
mesmerises = mesmerizes
mesmerising = mesmerizing
metabolise = metabolize
metabolised = metabolized
metabolises = metabolizes
metabolising = metabolizing
metaiodobenzylguanidine = meta-iodobenzylguanidine
metastasise = metastasize
metastasised = metastasized
metastasises = metastasizes
metastasising = metastasizing
methemoglobinaemia = methemoglobinemia
methemoglobinaemic = methemoglobinemic
methodise = methodize
methodised = methodized
methodises = methodizes
methodising = methodizing
methyltransferase = methyl-transferase
metrocoele = metrocele
metvix = Metvix
mezavant = Mezavant
micardis = Micardis
microcythaemia = microcythemia
microcythaemic = microcythemic
microhaematocrit = microhematocrit
microhaematuria = microhematuria
microinjection = micro-injection
microinjections = micro-injections
micrometers = micrometres
microminiaturise = microminiaturize
microminiaturised = microminiaturized
microminiaturises = microminiaturizes
microminiaturising = microminiaturizing
microorganism = micro-organism
microorganisms = micro-organisms
middleaged = middle-aged
midfollicular = mid-follicular
midluteal = mid-luteal
militarisation = militarization
militarise = militarize
militarised = militarized
militarises = militarizes
militarising = militarizing
milkpromoting = milk-promoting
milksecreting = milk-secreting
milliliter = millilitre
milliliters = millilitres
millimeter = millimetre
millimeters = millimetres
mineralise = mineralize
mineralised = mineralized
mineralises = mineralizes
mineralising = mineralizing
miniaturisation = miniaturization
miniaturise = miniaturize
miniaturised = miniaturized
miniaturises = miniaturizes
miniaturising = miniaturizing
minimisation = minimization
minimise = minimize
minimised = minimized
minimises = minimizes
minimising = minimizing
minirin = Minirin
minitran = Minitran
mirapex = Mirapex
mircera = Mircera
misbehavior = misbehaviour
mischaracterise = mischaracterize
mischaracterised = mischaracterized
mischaracterises = mischaracterizes
mischaracterising = mischaracterizing
mobicox = Mobicox
mobilisation = mobilization
mobilise = mobilize
mobilised = mobilized
mobiliser = mobilizer
mobilisers = mobilizers
mobilises = mobilizes
mobilising = mobilizing
modeled = modelled
modeling = modelling
modernisation = modernization
modernise = modernize
modernised = modernized
modernises = modernizes
modernising = modernizing
modularise = modularize
modularised = modularized
modularises = modularizes
modularising = modularizing
moisturise = moisturize
moisturised = moisturized
moisturiser = moisturizer
moisturisers = moisturizers
moisturises = moisturizes
moisturising = moisturizing
mold = mould
moldable = mouldable
molders = moulders
molding = moulding
molds = moulds
mongrelise = mongrelize
mongrelised = mongrelized
mongrelises = mongrelizes
mongrelising = mongrelizing
monoparaesthesia = monoparesthesia
monopolisation = monopolization
monopolise = monopolize
monopolised = monopolized
monopolises = monopolizes
monopolising = monopolizing
monopril = Monopril
monumentalise = monumentalize
monumentalised = monumentalized
monumentalises = monumentalizes
monumentalising = monumentalizing
moonlike = moon-like
moralisation = moralization
moralise = moralize
moralised = moralized
moraliser = moralizer
moralisers = moralizers
moralises = moralizes
moralising = moralizing
motorisation = motorization
motorise = motorize
motorised = motorized
motorises = motorizes
motorising = motorizing
mucinaemia = mucinemia
mucinaemic = mucinemic
mucocoele = mucocele
multicentre = multi-centre
multichannel = multi-channel
multicomponent = multi-component
multicopy = multi-copy
multifactorial = multi-factorial
multigland = multi-gland
multiglandular = multi-glandular
multilayered = multi-layered
multinodular = multi-nodular
multiorgan = multi-organ
multiphasic = multi-phasic
multistep = multi-step
multisystaemia = multisystemia
multisystaemic = multisystemic
municipalise = municipalize
municipalised = municipalized
municipalises = municipalizes
municipalising = municipalizing
muse = Muse
myaesthesia = myesthesia
mycamine = Mycamine
mycethaemia = mycethemia
mycethaemic = mycethemic
mycohaemia = mycohemia
mycohaemic = mycohemic
myelaemia = myelemia
myelaemic = myelemic
myelinizationisation = myelinization
myeloblastaemia = myeloblastemia
myeloblastaemic = myeloblastemic
myelocoele = myelocele
myelocystocoele = myelocystocele
myelocystomeningocoele = myelocystomeningocele
myelocythaemia = myelocythemia
myelocythaemic = myelocythemic
myelomeningocoele = myelomeningocele
myocet = Myocet
myocoele = myocele
myoischaemia = myoischemia
myoischaemic = myoischemic
myozyme = Myozyme
mythologise = mythologize
mythologised = mythologized
mythologises = mythologizes
mythologising = mythologizing
myxaemia = myxemia
myxaemic = myxemic
myxoedema = myxedema
naevi = nevi
naevocarcinoma = nevocarcinoma
naevolipoma = nevolipoma
naevoxanthoendothelioma = nevoxanthoendothelioma
naevus = nevus
nanometer = nanometre
nanometers = nanometres
naprelan = Naprelan
narcoanaesthesia = narcoanesthesia
narcotise = narcotize
narcotised = narcotized
narcotises = narcotizes
narcotising = narcotizing
naropin = Naropin
nasonex = Nasonex
nationalisation = nationalization
nationalisations = nationalizations
nationalise = nationalize
nationalised = nationalized
nationalises = nationalizes
nationalising = nationalizing
natraemia = natremia
natraemic = natremic
natrecor = Natrecor
naturalisation = naturalization
naturalise = naturalize
naturalised = naturalized
naturalises = naturalizes
naturalising = naturalizing
naysayer = nay-sayer
nebulizationisation = nebulization
neighbor = neighbour
neighborhood = neighbourhood
neighborhoods = neighbourhoods
neighboring = neighbouring
neighbors = neighbours
neoral = Neoral
neovascularizationisation = neovascularization
nephraemia = nephremia
nephraemic = nephremic
nephramine = Nephramine
nephrocoele = nephrocele
neulasta = Neulasta
neupogen = Neupogen
neuroectodermal = neuro-ectodermal
neuroleptanaesthesia = neuroleptanesthesia
neurontin = Neurontin
neutralisation = neutralization
neutralise = neutralize
neutralised = neutralized
neutraliser = neutralizer
neutralisers = neutralizers
neutralises = neutralizes
neutralising = neutralizing
nevanac = Nevanac
nexavar = Nexavar
nexium = Nexium
niaspan = Niaspan
nimbex = Nimbex
ninefold = nine-fold
nitraemia = nitremia
nitraemic = nitremic
nitroglycerine = nitro-glycerine
nonGH = non-GH
nonHDL = non-HDL
nonHodgkin = non-Hodgkin
nonMEN1 = non-MEN1
nonPTH = non-PTH
nonSCLCs = non-SCLCs
nonSHBG = non-SHBG
nonTeBG = non-TeBG
nonY = non-Y
nonabrasive = non-abrasive
nonabsorbed = non-absorbed
nonabsorbent = non-absorbent
nonacademic = non-academic
nonacid = non-acid
nonactivated = non-activated
nonactivation = non-activation
nonaddicting = non-addicting
nonaddictive = non-addictive
nonadenomatous = non-adenomatous
nonadipose = non-adipose
nonadjacent = non-adjacent
nonadjustable = non-adjustable
nonadrenal = non-adrenal
nonadrenergic = non-adrenergic
nonaffected = unaffected
nonaffiliated = non-affiliated
nonafflicted = non-afflicted
nonaggressive = non-aggressive
nonagricultural = non-agricultural
nonalcoholic = non-alcoholic
nonaligned = non-aligned
nonalignment = non-alignment
nonallelic = non-allelic
nonallergic = non-allergic
nonamidated = non-amidated
nonandrogen = non-androgen
nonangioinvasive = non-angioinvasive
nonangiotensin = non-angiotensin
nonanion = non-anion
nonantigen = non-antigen
nonappearance = non-appearance
nonaqueous = non-aqueous
nonaromatizable = non-aromatizable
nonarteritic = non-arteritic
nonassertive = non-assertive
nonassociation = non-association
nonathletes = non-athletes
nonathletic = non-athletic
nonattached = non-attached
nonattachment = non-attachment
nonattendance = non-attendance
nonauto = non-auto
nonautoimmune = non-autoimmune
nonautonomic = non-autonomic
nonautonomous = non-autonomous
nonbacterial = non-bacterial
nonbasal = non-basal
nonbearing = non-bearing
nonbeing = non-being
nonbeliever = non-believer
nonbelligerent = non-belligerent
nonbeta = non-beta
nonbiopsied = non-biopsied
nonblack = non-black
nonblacks = non-blacks
nonbreeding = non-breeding
nonbulky = non-bulky
nonburn = non-burn
nonbusiness = non-business
noncalcemic = non-calcemic
noncalcified = non-calcified
noncalcium = non-calcium
noncaloric = non-caloric
noncancer = non-cancer
noncancerous = non-cancerous
noncarbohydrate = non-carbohydrate
noncardiac = non-cardiac
noncardiogenic = non-cardiogenic
noncardioselective = non-cardioselective
noncardiovascular = non-cardiovascular
noncaseating = non-caseating
noncash = non-cash
noncellular = non-cellular
nonchalance = non-chalance
nonchalant = non-chalant
nonchalantly = non-chalantly
nonchemotherapy = non-chemotherapy
nonchest = non-chest
noncholinergic = non-cholinergic
noncholingeric = non-cholingeric
noncircular = non-circular
noncirrhotic = non-cirrhotic
nonclass = non-class
nonclassic = non-classic
nonclassical = non-classical
nonclearing = non-clearing
nonclinical = non-clinical
nonclonal = non-clonal
nonclotting = non-clotting
noncoagulability = non-coagulability
noncoding = non-coding
noncoenzymatic = non-coenzymatic
noncoital = non-coital
noncollagen = non-collagen
noncollagenous = non-collagenous
noncombatant = non-combatant
noncombatants = non-combatants
noncombustible = non-combustible
noncommercial = non-commercial
noncommissioned = non-commissioned
noncommital = non-commital
noncommittal = non-committal
noncommittally = non-committally
noncommunicating = non-communicating
noncommunist = non-communist
noncompetitive = non-competitive
noncompetitively = non-competitively
noncomplex = non-complex
noncomplexed = non-complexed
noncompliance = non-compliance
noncompliant = non-compliant
noncompulsory = non-compulsory
nonconception = non-conception
nonconductive = non-conductive
nonconductor = non-conductor
nonconformance = non-conformance
nonconforming = non-conforming
nonconformist = non-conformist
nonconformists = non-conformists
nonconformity = non-conformity
noncongenital = non-congenital
nonconjugated = non-conjugated
nonconscious = non-conscious
nonconsecutive = non-consecutive
nonconsensual = non-consensual
nonconsensus = non-consensus
nonconservative = non-conservative
nonconsummation = non-consummation
noncontiguous = non-contiguous
noncontinuous = non-continuous
noncontraceptive = non-contraceptive
noncontrast = non-contrast
noncontributing = non-contributing
noncontributory = non-contributory
noncontrolled = non-controlled
noncontroversial = non-controversial
noncontrovertible = non-controvertible
nonconvertible = non-convertible
noncoplanar = non-coplanar
noncorrespondences = non-correspondences
noncorticotropin = non-corticotropin
noncovalent = non-covalent
noncovalently = non-covalently
noncreative = non-creative
noncredit = non-credit
noncriminal = non-criminal
noncritically = non-critically
noncrystalline = non-crystalline
noncycling = non-cycling
noncytokine = non-cytokine
noncytolytic = non-cytolytic
nondairy = non-dairy
nondance = non-dance
nondecalcified = non-decalcified
nondeductible = non-deductible
nondefined = non-defined
nondeiodinative = non-deiodinative
nondeleted = non-deleted
nondemented = non-demented
nondenominational = non-denominational
nondependent = non-dependent
nondepolarizingising = nondepolarizing
nondepot = non-depot
nondepressed = non-depressed
nondescent = non-descent
nondescript = non-descript
nondescriptly = non-descriptly
nondestructive = non-destructive
nondetectable = non-detectable
nondiabetes = non-diabetes
nondiabetic = non-diabetic
nondiabetics = non-diabetics
nondiagnostic = non-diagnostic
nondialyzable = non-dialyzable
nondiffuse = non-diffuse
nondiffusible = non-diffusible
nondigestible = non-digestible
nondilated = non-dilated
nondiploid = non-diploid
nondirective = non-directive
nondisabled = non-disabled
nondisclosure = non-disclosure
nondisclosures = non-disclosures
nondiscrimination = non-discrimination
nondiscriminatory = non-discriminatory
nondisease = non-disease
nondisjunction = non-disjunction
nondisjunctional = non-disjunctional
nondividing = non-dividing
nondominant = non-dominant
nondrinker = non-drinker
nondrying = non-drying
nonductal = non-ductal
noneffective = non-effective
nonelectrolyte = non-electrolyte
nonelectrolytes = non-electrolytes
nonelemental = non-elemental
nonelevated = non-elevated
nonemergency = non-emergency
nonemergent = non-emergent
nonempty = non-empty
nonencapsulated = non-encapsulated
nonendemic = non-endemic
nonendocrine = non-endocrine
nonenhancing = non-enhancing
nonenlarged = non-enlarged
nonenteral = non-enteral
nonentities = non-entities
nonentity = non-entity
nonenveloped = non-enveloped
nonenzymatic = non-enzymatic
nonenzymatically = non-enzymatically
nonepithelial = non-epithelial
nonequilibrium = non-equilibrium
nonequivalence = non-equivalence
nonequivalent = non-equivalent
nonergot = non-ergot
nonerythropoietin = non-erythropoietin
nonessential = non-essential
nonesterified = non-esterified
nonevent = non-event
nonevents = non-events
nonexclusive = non-exclusive
nonexempt = non-exempt
nonexistence = non-existence
nonexistent = non-existent
nonexocytotic = non-exocytotic
nonexpanding = non-expanding
nonexpendable = non-expendable
nonexpressors = non-expressors
nonextracted = non-extracted
nonextraction = non-extraction
nonfactual = non-factual
nonfamilial = non-familial
nonfasting = non-fasting
nonfat = non-fat
nonfatal = non-fatal
nonfeasance = non-feasance
nonfederal = non-federal
nonferrous = non-ferrous
nonfertile = non-fertile
nonfiction = non-fiction
nonfigurative = non-figurative
nonfinite = non-finite
nonflammable = non-flammable
nonflexible = non-flexible
nonfluctuating = non-fluctuating
nonfluorescent = non-fluorescent
nonfocal = non-focal
nonfollicular = non-follicular
nonfood = non-food
nonfoods = non-foods
nonfreezing = non-freezing
nonfunction = non-function
nonfunctional = non-functional
nonfunctioning = non-functioning
nongaseous = non-gaseous
nongenetic = non-genetic
nongenital = non-genital
nongenomic = non-genomic
nongerminoma = non-germinoma
nongerminomatous = non-germinomatous
nongermline = non-germline
nongestational = non-gestational
nonglandular = non-glandular
nonglial = non-glial
nonglucocorticoid = non-glucocorticoid
nonglucose = non-glucose
nonglycated = non-glycated
nonglycosylated = non-glycosylated
nongoitrous = non-goitrous
nongonadal = non-gonadal
nongovernmental = non-governmental
nongrafted = non-grafted
nongravid = non-gravid
nongrowing = non-growing
nonhealing = non-healing
nonhematopoietic = non-hematopoietic
nonheme = non-heme
nonhemodynamic = non-hemodynamic
nonhemoglobin = non-haemoglobin
nonhemorrhagic = non-hemorrhagic
nonhepatectomized = non-hepatectomized
nonhepatic = non-hepatic
nonhereditary = non-hereditary
nonhierarchical = non-hierarchical
nonhirsute = non-hirsute
nonhistologic = non-histologic
nonhistone = non-histone
nonhomologous = non-homologous
nonhormonal = non-hormonal
nonhormone = non-hormone
nonhospitalized = non-hospitalized
nonhuman = non-human
nonhumoral = non-humoral
nonhypercalcemic = non-hypercalcemic
nonhypercalcitonemic = non-hypercalcitonemic
nonhyperglycemic = non-hyperglycemic
nonhyperinsulinemic = non-hyperinsulinemic
nonhypertensive = non-hypertensive
nonhypnotic = non-hypnotic
nonhypoxic = non-hypoxic
noniatrogenic = non-iatrogenic
nonidentical = non-identical
nonidentity = non-identity
nonideological = non-ideological
nonidiomatic = non-idiomatic
nonimaging = non-imaging
nonimmigrant = non-immigrant
nonimmune = non-immune
nonimmunoreactive = non-immunoreactive
nonimmunosuppressive = non-immunosuppressive
nonimpotent = non-impotent
noninactivated = non-inactivated
nonindustrial = non-industrial
noninfectious = non-infectious
noninflamed = non-inflamed
noninflammable = non-inflammable
noninflammatory = non-inflammatory
noninherited = non-inherited
noninnervated = non-innervated
noninsulin = non-insulin
noninsulinmediated = non-insulin-mediated
noninsulinoma = non-insulinoma
nonintegrated = non-integrated
nonintellectual = non-intellectual
nonintensive = non-intensive
noninterference = non-interference
nonintersecting = non-intersecting
nonintervention = non-intervention
noninterventionist = non-interventionist
noninvasive = non-invasive
noninvasively = non-invasively
noninvolved = non-involved
noninvolvement = non-involvement
noniodinated = non-iodinated
nonionic = non-ionic
nonionically = non-ionically
nonionizing = non-ionizing
nonirradiated = non-irradiated
nonirritant = non-irritant
nonirritating = non-irritating
nonislet = non-islet
nonisopeptide = non-isopeptide
nonisotopic = non-isotopic
nonjudgmental = non-judgmental
nonkeratinized = non-keratinized
nonketotic = non-ketotic
nonlabelled = non-labelled
nonlactating = non-lactating
nonleaded = non-leaded
nonlethal = non-lethal
nonlinear = non-linear
nonlinearity = non-linearity
nonlinearly = non-linearly
nonlinguistic = non-linguistic
nonlipid = non-lipid
nonliterary = non-literary
nonliving = non-living
nonloading = non-loading
nonluteal = non-luteal
nonlymphocytic = non-lymphocytic
nonlysosomal = non-lysosomal
nonmagnetic = non-magnetic
nonmalignant = non-malignant
nonmalleable = non-malleable
nonmammalian = non-mammalian
nonmast = non-mast
nonmaterial = non-material
nonmathematical = non-mathematical
nonmeal = non-meal
nonmeasurable = non-measurable
nonmedical = non-medical
nonmedicated = non-medicated
nonmember = non-member
nonmetal = non-metal
nonmetallic = non-metallic
nonmetals = non-metals
nonmetastasizing = non-metastasizing
nonmetastatic = non-metastatic
nonmidline = non-midline
nonmilitant = non-militant
nonmilitary = non-military
nonmineralized = non-mineralized
nonmineralocorticoid = non-mineralocorticoid
nonmitogenic = non-mitogenic
nonmitotic = non-mitotic
nonmodulating = non-modulating
nonmodulation = non-modulation
nonmodulator = non-modulator
nonmodulators = non-modulators
nonmosaic = non-mosaic
nonmotile = non-motile
nonmotilin = non-motilin
nonmoving = non-moving
nonmuscle = non-muscle
nonmuscular = non-muscular
nonmusical = non-musical
nonmydriatic = non-mydriatic
nonmyelinated = non-myelinated
nonnative = non-native
nonnatural = non-natural
nonnegative = non-negative
nonnegotiable = non-negotiable
nonneoplastic = non-neoplastic
nonneural = non-neural
nonneuroendocrine = non-neuroendocrine
nonneurogenic = non-neurogenic
nonneuronal = non-neuronal
nonnodular = non-nodular
nonnormal = non-normal
nonnumeric = non-numeric
nonnutritional = non-nutritional
nonnutritive = non-nutritive
nonobese = non-obese
nonobjective = non-objective
nonobligatory = non-obligatory
nonobservance = non-observance
nonobstetric = non-obstetric
nonobstructive = non-obstructive
nonoccurrence = non-occurrence
nonofficial = non-official
nononcocytic = non-oncocytic
nonoperated = non-operated
nonoperational = non-operational
nonoperativc = non-operativc
nonopioid = non-opioid
nonorgan = non-organ
nonorganic = non-organic
nonoriented = non-oriented
nonosmotic = non-osmotic
nonosseous = non-osseous
nonossifying = non-ossifying
nonosteoporotic = non-osteoporotic
nonovarian = non-ovarian
nonoverlapping = non-overlapping
nonoxidative = non-oxidative
nonoxidized = non-oxidized
nonoxynol = non-oxynol
nonoxyphilic = non-oxyphilic
nonpalpable = non-palpable
nonpancreatic = non-pancreatic
nonpancreaticoduodenal = non-pancreaticoduodenal
nonpapillary = non-papillary
nonparallel = non-parallel
nonparallelism = non-parallelism
nonparametric = non-parametric
nonparathyroid = non-parathyroid
nonpareil = non-pareil
nonparenchymal = non-parenchymal
nonparetic = non-paretic
nonparticipating = non-participating
nonparticipation = non-participation
nonparticipations = non-participations
nonparties = non-parties
nonpartisan = non-partisan
nonparty = non-party
nonpaternity = non-paternity
nonpathogenic = non-pathogenic
nonpathognomonic = non-pathognomonic
nonpathologic = non-pathologic
nonpaying = non-paying
nonpayment = non-payment
nonpedunculated = non-pedunculated
nonpenetrant = non-penetrant
nonpeptide = non-peptide
nonpeptides = non-peptides
nonpeptidyl = non-peptidyl
nonperformance = non-performance
nonperfused = non-perfused
nonperfusion = non-perfusion
nonperishable = non-perishable
nonpermanent = non-permanent
nonpharmacologic = non-pharmacologic
nonphosphorylated = non-phosphorylated
nonphotic = non-photic
nonphysical = non-physical
nonphysician = non-physician
nonphysicians = non-physicians
nonphysiologic = non-physiologic
nonpigmented = non-pigmented
nonpitting = non-pitting
nonpituitary = non-pituitary
nonplus = non-plus
nonpluses = non-pluses
nonplusing = non-plusing
nonpoisonous = non-poisonous
nonpolar = non-polar
nonpolitical = non-political
nonpolitically = non-politically
nonpolluting = non-polluting
nonpolyposis = non-polyposis
nonpolysomnographic = non-polysomnographic
nonporous = non-porous
nonpostpartum = non-postpartum
nonpredictable = non-predictable
nonpregnancy = non-pregnancy
nonpregnant = non-pregnant
nonprescription = non-prescription
nonprimate = non-primate
nonprimates = non-primates
nonprimed = non-primed
nonprocedural = non-procedural
nonproductive = non-productive
nonprofessional = non-professional
nonprofessionals = non-professionals
nonprofit = non-profit
nonprogrammer = non-programmer
nonprogressive = non-progressive
nonprolactin = non-prolactin
nonproliferation = non-proliferation
nonproliferative = non-proliferative
nonproportional = non-proportional
nonproportionally = non-proportionally
nonproprietary = non-proprietary
nonpropulsive = non-propulsive
nonprospective = non-prospective
nonprotein = non-protein
nonpruritic = non-pruritic
nonpublic = non-public
nonpuerperal = non-puerperal
nonpulmonary = non-pulmonary
nonpulsatile = non-pulsatile
nonpyknotic = non-pyknotic
nonracial = non-racial
nonracially = non-racially
nonradioactive = non-radioactive
nonradiolabeled = non-radiolabeled
nonrandom = non-random
nonrandomized = non-randomized
nonrandomly = non-randomly
nonrandomness = non-randomness
nonrapid = non-rapid
nonrational = non-rational
nonreactive = non-reactive
nonreactor = non-reactor
nonreader = non-reader
nonrealistic = non-realistic
nonreassuring = non-reassuring
nonreceptor = non-receptor
nonreciprocal = non-reciprocal
nonrecombining = non-recombining
nonrecurrent = non-recurrent
nonrecurring = non-recurring
nonreducing = non-reducing
nonreflecting = non-reflecting
nonrefluxing = non-refluxing
nonrefreshing = non-refreshing
nonregulated = non-regulated
nonrelated = non-related
nonrelaxation = non-relaxation
nonreligious = non-religious
nonrenal = non-renal
nonrenewable = non-renewable
nonrenin = non-renin
nonrepresentational = non-representational
nonrepresentative = non-representative
nonreproducibility = non-reproducibility
nonreproductive = non-reproductive
nonresectable = non-resectable
nonresident = non-resident
nonresidential = non-residential
nonresistance = non-resistance
nonresistant = non-resistant
nonresorbable = non-resorbable
nonresponders = non-responders
nonresponding = non-responding
nonresting = non-resting
nonrestrictive = non-restrictive
nonreversible = non-reversible
nonrheumatoid = non-rheumatoid
nonrhythmical = non-rhythmical
nonromantic = non-romantic
nonsalt = non-salt
nonsaturable = non-saturable
nonscarring = non-scarring
nonscheduled = non-scheduled
nonscientific = non-scientific
nonscientist = non-scientist
nonscientists = non-scientists
nonscrotal = non-scrotal
nonsecreting = non-secreting
nonsecretory = non-secretory
nonsectarian = non-sectarian
nonseeing = non-seeing
nonselective = non-selective
nonselectivity = non-selectivity
nonself = non-self
nonseminoma = non-seminoma
nonseminomas = non-seminomas
nonseminomas12 = non-seminomas12
nonseminomas15 = non-seminomas15
nonseminomatous = non-seminomatous
nonsensical = non-sensical
nonsensicality = non-sensicality
nonsensically = non-sensically
nonsensicalness = non-sensicalness
nonseptate = non-septate
nonseptic = non-septic
nonsequential = non-sequential
nonsex = non-sex
nonsexist = non-sexist
nonsexual = non-sexual
nonshivering = non-shivering
nonsignificant = non-significant
nonsingular = non-singular
nonsister = non-sister
nonskeletal = non-skeletal
nonskid = non-skid
nonskin = non-skin
nonsmall = non-small
nonsmoker = non-smoker
nonsmokers = non-smokers
nonsmoking = non-smoking
nonsocial = non-social
nonsolid = non-solid
nonspecialized = non-specialized
nonspecific = non-specific
nonspecifically = non-specifically
nonspecificity = non-specificity
nonspherocytic = non-spherocytic
nonspinal = non-spinal
nonspine = non-spine
nonstandard = non-standard
nonstarter = non-starter
nonsteady = non-steady
nonstenotic = non-stenotic
nonstereoselective = non-stereoselective
nonstereospecific = non-stereospecific
nonsteroid = non-steroid
nonsteroidogenic = non-steroidogenic
nonstick = non-stick
nonstimulated = non-stimulated
nonstone = non-stone
nonstop = non-stop
nonstoring = non-storing
nonstreak = non-streak
nonstress = non-stress
nonstressed = non-stressed
nonstructural = non-structural
nonsuccess = non-success
nonsuckling = non-suckling
nonsulfated = non-sulfated
nonsulfonylurea = non-sulfonylurea
nonsupport = non-support
nonsuppressed = non-suppressed
nonsuppressibility = non-suppressibility
nonsuppressible = non-suppressible
nonsuppression = non-suppression
nonsuppurative = non-suppurative
nonsurgical = non-surgical
nonsurgically = non-surgically
nonsurviving = non-surviving
nonsurvivors = non-survivors
nonsusceptible = non-susceptible
nonsymmetrical = non-symmetrical
nonsyndromal = non-syndromal
nonsyndromic = non-syndromic
nonsystematic = non-systematic
nontarget = non-target
nontaxable = non-taxable
nontender = non-tender
nontesticular = non-testicular
nonthreatening = non-threatening
nonthriving = non-thriving
nonthrombogenic = non-thrombogenic
nonthyroid = non-thyroid
nonthyroidal = non-thyroidal
nontoxic = non-toxic
nontraditional = non-traditional
nontrained = non-trained
nontransferable = non-transferable
nontransient = non-transient
nontranslated = non-translated
nontransparent = non-transparent
nontraumatic = non-traumatic
nontreatable = non-treatable
nontreated = non-treated
nontrivial = non-trivial
nontrophoblastic = non-trophoblastic
nontropical = non-tropical
nontuberculous = non-tuberculous
nontwin = non-twin
nontype = non-type
nontyphoidal = non-typhoidal
nonuniform = non-uniform
nonuniformity = non-uniformity
nonunion = non-union
nonuse = non-use
nonuser = non-user
nonusers = non-users
nonvalvular = non-valvular
nonvariceal = non-variceal
nonvascular = non-vascular
nonventilated = non-ventilated
nonverbal = non-verbal
nonverbally = non-verbally
nonvertebral = non-vertebral
nonviable = non-viable
nonvigorous = non-vigorous
nonviolence = non-violence
nonviolent = non-violent
nonviolently = non-violently
nonvisible = non-visible
nonvisualized = non-visualized
nonvolatile = non-volatile
nonvolitional = non-volitional
nonvoluntary = non-voluntary
nonvoter = non-voter
nonvoting = non-voting
nonweight = non-weight
nonwestern = non-western
nonwesternized = non-westernized
nonwhite = non-white
nonwhites = non-whites
nonworking = non-working
nonzero = non-zero
normalisation = normalization
normalisations = normalizations
normalise = normalize
normalised = normalized
normalises = normalizes
normalising = normalizing
normocalcaemia = normocalcemia
normocalcaemic = normocalcemic
normoglycaemia = normoglycemia
normoglycaemic = normoglycemic
normovolaemic = normovolemic
norvasc = Norvasc
norvir = Norvir
notarisation = notarization
notarise = notarize
notarised = notarized
notarises = notarizes
notarising = notarizing
notencephalocoele = notencephalocele
novelise = novelize
novelised = novelized
novelises = novelizes
novelising = novelizing
novomix = Novomix
novorapid = Novorapid
nph = NPH
nucleotidebinding = nucleotide-binding
nutropin = Nutropin
odor = odour
odorise = odorize
odorised = odorized
odorises = odorizes
odorising = odorizing
odors = odours
oedema = edema
oedematous = edematous
oesophagalgia = esophagalgia
oesophageal = esophageal
oesophagectasia = esophagectasia
oesophagectasis = esophagectasis
oesophagectomy = esophagectomy
oesophagismus = esophagismus
oesophagitis = esophagitis
oesophagocoele = esophagocele
oesophagodynia = esophagodynia
oesophagogastrectomy = esophagogastrectomy
oesophagogastric = esophagogastric
oesophagogastroanastomosis = esophagogastroanastomosis
oesophagogastroplasty = esophagogastroplasty
oesophagojejunostomy = esophagojejunostomy
oesophagomalacia = esophagomalacia
oesophagoplasty = esophagoplasty
oesophagoplication = esophagoplication
oesophagoptosia = esophagoptosia
oesophagoptosis = esophagoptosis
oesophagoscope = esophagoscope
oesophagoscopy = esophagoscopy
oesophagospasm = esophagospasm
oesophagostenosis = esophagostenosis
oesophagostomy = esophagostomy
oesophagotome = esophagotome
oesophagotomy = esophagotomy
oesophagram = esophagram
oesophagus = esophagus
oestradiol = estradiol
oestriol = estriol
oestrogen = estrogen
oestrogenic = estrogenic
oestrogens = estrogens
offenses = offences
oligaemia = oligemia
oligaemic = oligemic
oligohaemia = oligohemia
oligohaemic = oligohemic
oligoleukocythaemia = oligoleukocythemia
oligoleukocythaemic = oligoleukocythemic
oligomenorrhoea = oligomenorrhea
oligopnoea = oligopnea
olmetec = Olmetec
omnaris = Omnaris
omniscan = Omniscan
omphalocoele = omphalocele
omphalocoeles = omphaloceles
ongoing = on-going
ophthalmocoele = ophthalmocele
opioidlike = opioid-like
opsonizationisation = opsonization
opsonizedised = opsonized
opsonizeise = opsonize
opsonizingising = opsonizing
optaesthesia = optesthesia
optimisation = optimization
optimisations = optimizations
optimise = optimize
optimised = optimized
optimiser = optimizer
optimisers = optimizers
optimises = optimizes
optimising = optimizing
oraqix = Oraqix
orbax = Orbax
orchidocoele = orchidocele
orchiocoele = orchiocele
orchioscheocoele = orchioscheocele
orencia = Orencia
organisation = organization
organisational = organizational
organisations = organizations
organise = organize
organised = organized
organiser = organizer
organisers = organizers
organises = organizes
organising = organizing
orgaran = Orgaran
orthopaedic = orthopedic
orthopaedics = orthopedics
orthopaedist = orthopedist
orthopaedists = orthopedists
orthopnoea = orthopnea
orthopnoeic = orthopneic
oscheocoele = oscheocele
ostaemia = ostemia
ostaemic = ostemic
osteoanaesthesia = osteoanesthesia
ostracise = ostracize
ostracised = ostracized
ostracises = ostracizes
ostracising = ostracizing
otopyorrhoea = otopyorrhea
otorrhoea = otorrhea
ovariocoele = ovariocele
overactivity = over-activity
overcapitalisation = overcapitalization
overcapitalise = overcapitalize
overcapitalised = overcapitalized
overcapitalises = overcapitalizes
overcapitalising = overcapitalizing
overemphasise = overemphasize
overemphasised = overemphasized
overemphasises = overemphasizes
overemphasising = overemphasizing
overexpress = over-express
overexpressed = over-expressed
overexpression = over-expression
oversaturation = over-saturation
oversecretion = over-secretion
overspecialisation = overspecialization
overspecialise = overspecialize
overspecialised = overspecialized
overspecialises = overspecializes
overspecialising = overspecializing
overstimulation = over-stimulation
oxalaemia = oxalemia
oxalaemic = oxalemic
oxidisation = oxidization
oxidise = oxidize
oxidised = oxidized
oxidiser = oxidizer
oxidisers = oxidizers
oxidises = oxidizes
oxidising = oxidizing
oxyaesthesia = oxyesthesia
oxycontin = Oxycontin
oxygenise = oxygenize
oxygenised = oxygenized
oxygenises = oxygenizes
oxygenising = oxygenizing
oxyhaemoglobin = oxyhemoglobin
pachyaemia = pachyemia
pachyaemic = pachyemic
pachydermatocoele = pachydermatocele
paediatric = pediatric
paediatrician = pediatrician
paediatricians = pediatricians
paediatrics = pediatrics
paedophile = pedophile
paedophiles = pedophiles
paedophilia = pedophilia
palaeogenesis = paleogenesis
palaeontologist = paleontologist
palaeontologists = paleontologists
palaeontology = paleontology
palafer = Palafer
palatalise = palatalize
palatalised = palatalized
palatalises = palatalizes
palatalising = palatalizing
palladone = Palladone
pallaesthesia = pallesthesia
pallanaesthesia = pallanesthesia
palletise = palletize
palletised = palletized
palletises = palletizes
palletising = palletizing
palmitoyltransferase = palmitoyl-transferase
panaesthesia = panesthesia
panegyrise = panegyrize
panegyrised = panegyrized
panegyrises = panegyrizes
panegyrising = panegyrizing
panelise = panelize
panelised = panelized
panelises = panelizes
panelising = panelizing
panhyperaemia = panhyperemia
panhyperaemic = panhyperemic
panretinal = pan-retinal
panto = Panto
pantoloc = Pantoloc
papilloedema = papilledema
paraaesthesia = paraesthesia
paracenaesthesia = paracenesthesia
paraesthesia = paresthesia
paraesthesiae = paresthesiae
paraesthesias = paresthesias
paraesthetica = paresthetica
paralyze = paralyse
paralyzed = paralysed
paralyzes = paralyses
paralyzing = paralysing
parameterisation = parameterization
parameterise = parameterize
parameterised = parameterized
parameterises = parameterizes
parameterising = parameterizing
paraphaemia = paraphemia
paraphaemic = paraphemic
paraproteinaemia = paraproteinemia
parasitaemia = parasitemia
parasitaemic = parasitemic
parasitise = parasitize
parasitised = parasitized
parasitises = parasitizes
parasitising = parasitizing
paratect = Paratect
parceled = parcelled
parceling = parcelling
parencephalocoele = parencephalocele
parenthesise = parenthesize
parenthesised = parenthesized
parenthesises = parenthesizes
parenthesising = parenthesizing
pariet = Pariet
particularisation = particularization
particularise = particularize
particularised = particularized
particularises = particularizes
particularising = particularizing
pasteurisation = pasteurization
pasteurise = pasteurize
pasteurised = pasteurized
pasteurises = pasteurizes
pasteurising = pasteurizing
patanol = Patanol
patronisation = patronization
patronise = patronize
patronised = patronized
patronises = patronizes
patronising = patronizing
pauperisation = pauperization
pauperise = pauperize
pauperised = pauperized
pauperises = pauperizes
pauperising = pauperizing
paxil = Paxil
pegasys = Pegasys
pegetron = Pegetron
penalisation = penalization
penalise = penalize
penalised = penalized
penalises = penalizes
penalising = penalizing
pentasa = Pentasa
pepcid = Pepcid
peptidenegative = peptide-negative
peptise = peptize
peptised = peptized
peptises = peptizes
peptising = peptizing
percocet = Percocet
perineocoele = perineocele
permax = Permax
personalisation = personalization
personalise = personalize
personalised = personalized
personalises = personalizes
personalising = personalizing
pesticaemia = pesticemia
pesticaemic = pesticemic
phacocoele = phacocele
pharmacopoeia = pharmacopeia
pharmacopoeias = pharmacopeias
pharyngocoele = pharyngocele
phenolaemia = phenolemia
phenolaemic = phenolemic
phenylalaninaemia = phenylalaninemia
phenylalaninaemic = phenylalaninemic
philosophise = philosophize
philosophised = philosophized
philosophiser = philosophizer
philosophisers = philosophizers
philosophises = philosophizes
philosophising = philosophizing
phlebotomise = phlebotomize
phlebotomised = phlebotomized
phlebotomises = phlebotomizes
phlebotomising = phlebotomizing
phosmax = PhosMax
phosphataemia = phosphatemia
phosphataemic = phosphatemic
phosphataselike = phosphatase-like
photofrin = Photofrin
photosensitisation = photosensitization
photosensitise = photosensitize
photosensitised = photosensitized
photosensitises = photosensitizes
photosensitising = photosensitizing
photosynthesise = photosynthesize
photosynthesised = photosynthesized
photosynthesises = photosynthesizes
photosynthesising = photosynthesizing
pionaemia = pionemia
pionaemic = pionemic
plagiarise = plagiarize
plagiarised = plagiarized
plagiariser = plagiarizer
plagiarisers = plagiarizers
plagiarises = plagiarizes
plagiarising = plagiarizing
plantlike = plant-like
plaquenil = Plaquenil
plavix = Plavix
pleurocoele = pleurocele
pluralise = pluralize
pluralised = pluralized
pluralises = pluralizes
pluralising = pluralizing
pneumatocoele = pneumatocele
pneumocoele = pneumocele
pneumohaemia = pneumohemia
pneumohaemic = pneumohemic
pneumonocoele = pneumonocele
poeticise = poeticize
poeticised = poeticized
poeticises = poeticizes
poeticising = poeticizing
poetise = poetize
poetised = poetized
poetises = poetizes
poetising = poetizing
polarisation = polarization
polarise = polarize
polarised = polarized
polarises = polarizes
polarising = polarizing
politicisation = politicization
politicise = politicize
politicised = politicized
politicises = politicizes
politicising = politicizing
polyaesthesia = polyesthesia
polycythaemia = polycythemia
polycythaemic = polycythemic
polyhaemia = polyhemia
polyhaemic = polyhemic
polymenorrhoea = polymenorrhea
polymerisation = polymerization
polymerise = polymerize
polymerised = polymerized
polymerises = polymerizes
polymerising = polymerizing
polymerizationisation = polymerization
popularisation = popularization
popularise = popularize
popularised = popularized
popularises = popularizes
popularising = popularizing
porocoele = porocele
posanol = Posanol
post-anaesthesia = post-anesthesia
postabsorptive = post-absorptive
postanaesthesia = postanesthesia
postcoital = post-coital
postganglionic = post-ganglionic
posthyperglycaemic = post-hyperglycaemic
postimplantation = post-implantation
postmarketing = post-marketing
postmeal = post-meal
postmenopausal = post-menopausal
postnatal = post-natal
postobstructive = post-obstructive
postprandially = post-prandially
postpubertal = post-pubertal
postpubertally = post-pubertally
postradioiodine = post-radioiodine
postreceptor = post-receptor
postsurgical = post-surgical
postsynaptic = post-synaptic
postviral = post-viral
postzygotic = post-zygotic
potassaemia = potassemia
potassaemic = potassemic
pouchlike = pouch-like
pradax = Pradax
pravachol = Pravachol
preanaesthesia = preanesthesia
preantral = pre-antral
preauthorise = preauthorize
preauthorised = preauthorized
preauthorises = preauthorizes
preauthorising = preauthorizing
preclinical = pre-clinical
precognisant = precognizant
preeclampsia = pre-eclampsia
preempt = pre-empt
preexisting = pre-existing
prefesta = Prefesta
preganglionic = pre-ganglionic
preleukaemia = preleukemia
preleukaemic = preleukemic
premalignant = pre-malignant
premarin = Premarin
premeal = pre-meal
premenopausal = pre-menopausal
prenatal = pre-natal
preoptic = pre-optic
preorder = pre-order
preordered = pre-ordered
preordering = pre-ordering
preorders = pre-orders
preovulatory = pre-ovulatory
prepregnancy = pre-pregnancy
prepubertally = pre-pubertally
prepuberty = pre-puberty
prerecord = pre-record
prerecorded = pre-recorded
prerecording = pre-recording
prerecords = pre-records
prerelease = pre-release
prereleased = pre-released
prereleases = pre-releases
prereleasing = pre-releasing
preretinal = pre-retinal
presegment = pre-segment
pressurisation = pressurization
pressurise = pressurize
pressurised = pressurized
pressurises = pressurizes
pressurising = pressurizing
presupper = pre-supper
presynaptic = pre-synaptic
pretense = pretence
pretenses = pretences
preterm = pre-term
pretibial = pre-tibial
prevacid = Prevacid
previcox = Previcox
prezista = Prezista
prioritisation = prioritization
prioritise = prioritize
prioritised = prioritized
prioritises = prioritizes
prioritising = prioritizing
pristiq = Pristiq
privatisation = privatization
privatise = privatize
privatised = privatized
privatises = privatizes
privatising = privatizing
proctocoele = proctocele
profender = Profender
prograf = Prograf
prohance = Prohance
proinflammatory = pro-inflammatory
prolev = Prolev
propagandise = propagandize
propagandised = propagandized
propagandises = propagandizes
propagandising = propagandizing
propecia = Propecia
proscar = Proscar
proselytise = proselytize
proselytised = proselytized
proselytiser = proselytizer
proselytisers = proselytizers
proselytises = proselytizes
proselytising = proselytizing
prostep = Prostep
proteinbinding = protein-binding
proteinlike = protein-like
proteinmediated = protein-mediated
proteinrelated = protein-related
protopic = Protopic
protropin = Protropin
pseudoaesthesia = pseudoesthesia
pseudoanaemia = pseudoanemia
pseudoanaemic = pseudoanemic
pseudochromaesthesia = pseudochromesthesia
pseudogene = pseudo-gene
pseudogenes = pseudo-genes
pseudogeusaesthesia = pseudogeusesthesia
pseudohaematuria = pseudohematuria
pseudohaemoptysis = pseudohemoptysis
pseudohypoaldosteronism = pseudo-hypoaldosteronism
pseudohyponatraemia = pseudo-hyponatraemia
pseudoleukaemia = pseudoleukemia
pseudoleukaemic = pseudoleukemic
pseudotumour = pseudo-tumour
pseudovaginal = pseudo-vaginal
psychroaesthesia = psychroesthesia
ptyalocoele = ptyalocele
publicise = publicize
publicised = publicized
publicises = publicizes
publicising = publicizing
pulverisation = pulverization
pulverise = pulverize
pulverised = pulverized
pulverises = pulverizes
pulverising = pulverizing
puregon = Puregon
purinaemia = purinemia
purinaemic = purinemic
pyaemia = pyemia
pyaemic = pyemic
pycnaemia = pycnemia
pycnaemic = pycnemic
pyknaemia = pyknemia
pyknaemic = pyknemic
pylorid = Pylorid
pyocoele = pyocele
pyocolpocoele = pyocolpocele
pyohaemia = pyohemia
pyohaemic = pyohemic
pyorrhoea = pyorrhea
pyosaemia = pyosemia
pyosaemic = pyosemic
pyotorrhoea = pyotorrhea
pyotoxinaemia = pyotoxinemia
pyotoxinaemic = pyotoxinemic
quomem = Quomem
qvar = Qvar
rabbeting = rabbetting
rachianaesthesia = rachianesthesia
rachicoele = rachicele
radicalisation = radicalization
radicalise = radicalize
radicalised = radicalized
radicalises = radicalizes
radicalising = radicalizing
radiotoxaemia = radiotoxemia
radiotoxaemic = radiotoxemic
radioulnar = radio-ulnar
ramace = Ramace
rancor = rancour
randomisation = randomization
randomise = randomize
randomised = randomized
randomiser = randomizer
randomisers = randomizers
randomises = randomizes
randomising = randomizing
rapamune = Rapamune
rapidacting = rapid-acting
rasilez = Rasilez
rationalisation = rationalization
rationalise = rationalize
rationalised = rationalized
rationalises = rationalizes
rationalising = rationalizing
raxar = Raxar
reacclimatise = reacclimatize
reacclimatised = reacclimatized
reacclimatises = reacclimatizes
reacclimatising = reacclimatizing
reactine = Reactine
realisable = realizable
realisation = realization
realise = realize
realised = realized
realises = realizes
realising = realizing
reassociates = re-associates
reauthorisation = reauthorization
reauthorise = reauthorize
reauthorised = reauthorized
reauthorises = reauthorizes
reauthorising = reauthorizing
rebetron = Rebetron
rebif = Rebif
receptoractivating = receptor-activating
receptorassociated = receptor-associated
receptorbinding = receptor-binding
receptorblocking = receptor-blocking
receptordeficient = receptor-deficient
receptordependent = receptor-dependent
receptorindependent = receptorin-dependent
receptorlike = receptor-like
receptormediated = receptor-mediated
receptornegative = receptorn-egative
receptorpositive = receptor-positive
receptorrelated = receptor-related
receptorsignalling = receptor-signalling
recognisable = recognizable
recognisably = recognizably
recognisance = recognizance
recognise = recognize
recognised = recognized
recogniser = recognizer
recognisers = recognizers
recognises = recognizes
recognising = recognizing
reconnoiter = reconnoitre
reconnoitered = reconnoitred
reconnoitering = reconnoitring
reconnoiters = reconnoitres
rectocoele = rectocele
reeducate = re-educate
reenact = re-enact
reenlisting = re-enlisting
reenter = re-enter
reentered = re-entered
reentering = re-entering
reenters = re-enters
reestablish = re-establish
reestablished = re-established
reestablishing = re-establishing
reestablishment = re-establishment
reesterified = re-esterified
reexamine = re-examine
reexploration = re-exploration
refacto = Refacto
refludan = Refludan
refueled = refuelled
refueling = refuelling
regionalise = regionalize
regionalised = regionalized
regionalises = regionalizes
regionalising = regionalizing
regionalizedised = regionalized
regranex = Regranex
regularisation = regularization
regularise = regularize
regularised = regularized
regularises = regularizes
regularising = regularizing
reinitialise = reinitialize
reinitialised = reinitialized
reinitialises = reinitializes
reinitialising = reinitializing
relenza = Relenza
relpax = Relpax
rematerialise = rematerialize
rematerialised = rematerialized
rematerialises = rematerializes
rematerialising = rematerializing
remicade = Remicade
remilitarisation = remilitarization
remilitarise = remilitarize
remilitarised = remilitarized
remilitarises = remilitarizes
remilitarising = remilitarizing
reminyl = Reminyl
remobilisation = remobilization
remobilise = remobilize
remobilised = remobilized
remobilises = remobilizes
remobilising = remobilizing
remodeled = remodelled
remodeling = remodelling
remoulds = remolds
renagel = Renagel
renormalise = renormalize
renormalised = renormalized
renormalises = renormalizes
renormalising = renormalizing
reoperation = re-operation
reopro = Reopro
reorganisation = reorganization
reorganise = reorganize
reorganised = reorganized
reorganiser = reorganizer
reorganisers = reorganizers
reorganises = reorganizes
reorganising = reorganizing
replagal = Replagal
reprioritisation = reprioritization
requip = Requip
rescriptor = Rescriptor
resistancelike = resistance-like
retavase = Retavase
retrovir = Retrovir
reutilise = reutilize
reutilised = reutilized
reutilises = reutilizes
reutilising = reutilizing
revalorisation = revalorization
revatio = Revatio
reveled = revelled
reveling = revelling
revitalisation = revitalization
revitalise = revitalize
revitalised = revitalized
revitalises = revitalizes
revitalising = revitalizing
revlimid = Revlimid
revolution = Revolution
revolutionise = revolutionize
revolutionised = revolutionized
revolutionises = revolutionizes
revolutionising = revolutionizing
reyataz = Reyataz
rhapsodise = rhapsodize
rhapsodised = rhapsodized
rhapsodises = rhapsodizes
rhapsodising = rhapsodizing
rheumatoidlike = rheumatoid-like
rhinaesthesia = rhinesthesia
rhinorrhoea = rhinorrhea
rigors = rigours
rilutek = Rilutek
ringlike = ring-like
risperdal = Risperdal
ritualise = ritualize
ritualised = ritualized
ritualises = ritualizes
ritualising = ritualizing
rituxan = Rituxan
rivaled = rivalled
rivaling = rivalling
robotise = robotize
robotised = robotized
robotises = robotizes
robotising = robotizing
rocaltrol = Rocaltrol
rodlike = rod-like
roferon = Roferon
romanticise = romanticize
romanticised = romanticized
romanticises = romanticizes
romanticising = romanticizing
rosasol = Rosasol
rubberise = rubberize
rubberised = rubberized
rubberises = rubberizes
rubberising = rubberizing
rumor = rumour
rumored = rumoured
rumors = rumours
rythmol = Rythmol
saber = sabre
sabered = sabred
sabers = sabres
saclike = sac-like
sandimmune = Sandimmune
sandostatin = Sandostatin
sanitisation = sanitization
sanitise = sanitize
sanitised = sanitized
sanitiser = sanitizer
sanitisers = sanitizers
sanitises = sanitizes
sanitising = sanitizing
satirise = satirize
satirised = satirized
satirises = satirizes
satirising = satirizing
sativex = Sativex
savior = saviour
saviors = saviours
savored = savoured
savoring = savouring
savors = savours
scandalise = scandalize
scandalised = scandalized
scandalises = scandalizes
scandalising = scandalizing
scataemia = scatemia
scataemic = scatemic
scepter = sceptre
sceptered = sceptred
scepters = sceptres
schematisation = schematization
schematise = schematize
schematised = schematized
schematises = schematizes
schematising = schematizing
scleroedema = scleredema
scoretaemia = scoretemia
scoretaemic = scoretemic
scrotocoele = scrotocele
scrutinise = scrutinize
scrutinised = scrutinized
scrutiniser = scrutinizer
scrutinisers = scrutinizers
scrutinises = scrutinizes
scrutinising = scrutinizing
seasonale = Seasonale
sebivo = Sebivo
seborrhoea = seborrhea
seborrhoeic = seborrheic
sectionalise = sectionalize
sectionalised = sectionalized
sectionalises = sectionalizes
sectionalising = sectionalizing
secularisation = secularization
secularise = secularize
secularised = secularized
seculariser = secularizer
secularisers = secularizers
secularises = secularizes
secularising = secularizing
seimaesthesia = seimesthesia
sensationalise = sensationalize
sensationalised = sensationalized
sensationalises = sensationalizes
sensationalising = sensationalizing
sensipar = Sensipar
sensitisation = sensitization
sensitise = sensitize
sensitised = sensitized
sensitises = sensitizes
sensitising = sensitizing
sensitizingising = sensitizing
sentimentalisation = sentimentalization
sentimentalise = sentimentalize
sentimentalised = sentimentalized
sentimentalises = sentimentalizes
sentimentalising = sentimentalizing
septaemia = septemia
septaemic = septemic
septicaemia = septicemia
septicaemic = septicemic
septicopyaemia = septicopyemia
septicopyaemic = septicopyemic
septooptic = septo-optic
sepulcher = sepulchre
serevent = Serevent
serialisation = serialization
serialise = serialize
serialised = serialized
serialises = serializes
serialising = serializing
sermonise = sermonize
sermonised = sermonized
sermoniser = sermonizer
sermonisers = sermonizers
sermonises = sermonizes
sermonising = sermonizing
seroquel = Seroquel
sevenfold = seven-fold
severalfold = several-fold
sexualise = sexualize
sexualised = sexualized
sexualises = sexualizes
sexualising = sexualizing
sheikdom = sheikhdom
sheikdoms = sheikhdoms
sheiks = sheikhs
shocklike = shock-like
shortterm = short-term
shoveled = shovelled
shoveling = shovelling
shriveled = shrivelled
shriveling = shrivelling
sialocoele = sialocele
sialorrhoea = sialorrhea
sicklaemia = sicklemia
sicklaemic = sicklemic
signaled = signalled
signaling = signalling
signalisation = signalization
signalise = signalize
signalised = signalized
signalises = signalizes
signalising = signalizing
simaesthesia = simesthesia
simonise = simonize
simonised = simonized
simonises = simonizes
simonising = simonizing
simulect = Simulect
sinemet = Sinemet
singulair = Singulair
singularise = singularize
singularised = singularized
singularises = singularizes
singularising = singularizing
sixfold = six-fold
skelid = Skelid
skillful = skilful
skillfully = skilfully
skillfulness = skilfulness
slenderise = slenderize
slenderised = slenderized
slenderises = slenderizes
slenderising = slenderizing
slentrol = Slentrol
slitlike = slit-like
smolder = smoulder
snakelike = snake-like
sniveling = snivelling
socialisation = socialization
socialise = socialize
socialised = socialized
socialises = socializes
socialising = socializing
sodomise = sodomize
sodomised = sodomized
sodomises = sodomizes
sodomising = sodomizing
solage = Solage
solaraze = Solaraze
solemnisation = solemnization
solemnise = solemnize
solemnised = solemnized
solemnises = solemnizes
solemnising = solemnizing
soliloquise = soliloquize
soliloquised = soliloquized
soliloquises = soliloquizes
soliloquising = soliloquizing
somaesthesia = somesthesia
somastaesthesia = somastesthesia
somatuline = Somatuline
somavert = Somavert
soundproof = sound-proof
spadelike = spade-like
spasmophaemia = spasmophemia
spasmophaemic = spasmophemic
specialisation = specialization
specialise = specialize
specialised = specialized
specialises = specializes
specialising = specializing
specter = spectre
specters = spectres
spermatocoele = spermatocele
spermatorrhoea = spermatorrhea
spheraesthesia = spheresthesia
spiraled = spiralled
spiraling = spiralling
spiritualisation = spiritualization
spiritualise = spiritualize
spiritualised = spiritualized
spiritualises = spiritualizes
spiritualising = spiritualizing
spiriva = Spiriva
spirochetaemia = spirochetemia
spirochetaemic = spirochetemic
splanchnaesthesia = splanchnesthesia
splanchnocoele = splanchnocele
splenaemia = splenemia
splenaemic = splenemic
splendor = splendour
splenocoele = splenocele
splenohaemia = splenohemia
splenohaemic = splenohemic
sporanox = Sporanox
stabilisation = stabilization
stabilise = stabilize
stabilised = stabilized
stabiliser = stabilizer
stabilisers = stabilizers
stabilises = stabilizes
stabilising = stabilizing
standardisation = standardization
standardise = standardize
standardised = standardized
standardises = standardizes
standardising = standardizing
staphylococcaemia = staphylococcemia
staphylococcaemic = staphylococcemic
staphylohaemia = staphylohemia
staphylohaemic = staphylohemic
starlix = Starlix
steatocoele = steatocele
steatorrhoea = steatorrhea
stemgen = Stemgen
stereoanaesthesia = stereoanesthesia
sterilisation = sterilization
sterilise = sterilize
sterilised = sterilized
steriliser = sterilizer
sterilisers = sterilizers
sterilises = sterilizes
sterilising = sterilizing
steroiddependent = steroid-dependent
steroidindependent = steroid-independent
steroidsecreting = steroid-secreting
stigmatisation = stigmatization
stigmatise = stigmatize
stigmatised = stigmatized
stigmatises = stigmatizes
stigmatising = stigmatizing
stonelike = stone-like
strattera = Strattera
strepticaemia = strepticemia
strepticaemic = strepticemic
streptococcaemia = streptococcemia
streptococcaemic = streptococcemic
streptosepticaemia = streptosepticemia
streptosepticaemic = streptosepticemic
stressrelated = stress-related
structuralise = structuralize
structuralised = structuralized
structuralises = structuralizes
structuralising = structuralizing
stylisation = stylization
stylise = stylize
stylised = stylized
stylises = stylizes
stylising = stylizing
subcategorise = subcategorize
subcategorised = subcategorized
subcategorises = subcategorizes
subcategorising = subcategorizing
suboptimal = sub-optimal
subsidisation = subsidization
subsidise = subsidize
subsidised = subsidized
subsidiser = subsidizer
subsidisers = subsidizers
subsidises = subsidizes
subsidising = subsidizing
subunitlike = subunit-like
suburbanise = suburbanize
suburbanised = suburbanized
suburbanises = suburbanizes
suburbanising = suburbanizing
succor = succour
sulfonylurea = sulphonylurea
sulfonylureas = sulphonylureas
sulphate = sulfate
sulphates = sulfates
sulphide = sulfide
sulphides = sulfides
sulphite = sulfite
sulphites = sulfites
sulphur = sulfur
summarisation = summarization
summarise = summarize
summarised = summarized
summariser = summarizer
summarisers = summarizers
summarises = summarizes
summarising = summarizing
suprane = Suprane
supraoptic = supra-optic
sustiva = Sustiva
sutent = Sutent
swiveled = swivelled
swiveling = swivelling
symbicort = Symbicort
symbolisation = symbolization
symbolise = symbolize
symbolised = symbolized
symbolises = symbolizes
symbolising = symbolizing
sympathise = sympathize
sympathised = sympathized
sympathiser = sympathizer
sympathisers = sympathizers
sympathises = sympathizes
sympathising = sympathizing
symphonise = symphonize
symphonised = symphonized
symphonises = symphonizes
symphonising = symphonizing
synaesthesia = synesthesia
synagis = Synagis
synarel = Synarel
synchronisation = synchronization
synchronise = synchronize
synchronised = synchronized
synchroniser = synchronizer
synchronisers = synchronizers
synchronises = synchronizes
synchronising = synchronizing
syndromekilling = syndrome-killing
syndromelike = syndrome-like
synopsise = synopsize
synopsised = synopsized
synopsises = synopsizes
synopsising = synopsizing
synthesise = synthesize
synthesised = synthesized
synthesiser = synthesizer
synthesisers = synthesizers
synthesises = synthesizes
synthesising = synthesizing
synvisc = Synvisc
systematisation = systematization
systematise = systematize
systematised = systematized
systematises = systematizes
systematising = systematizing
systemisation = systemization
systemise = systemize
systemised = systemized
systemises = systemizes
systemising = systemizing
tabularise = tabularize
tabularised = tabularized
tabularises = tabularizes
tabularising = tabularizing
tachyphaemia = tachyphemia
tachyphaemic = tachyphemic
tachypnoea = tachypnea
tamiflu = Tamiflu
tantalisation = tantalization
tantalise = tantalize
tantalised = tantalized
tantaliser = tantalizer
tantalisers = tantalizers
tantalises = tantalizes
tantalising = tantalizing
tapazole = Tapazole
tarceva = Tarceva
tarka = Tarka
taxol = Taxol
taxotere = Taxotere
tazocin = Tazocin
tazorac = Tazorac
telaesthesia = telesthesia
temodal = Temodal
temporisation = temporization
temporise = temporize
temporised = temporized
temporiser = temporizer
temporisers = temporizers
temporises = temporizes
temporising = temporizing
tenderisation = tenderization
tenderise = tenderize
tenderised = tenderized
tenderiser = tenderizer
tenderisers = tenderizers
tenderises = tenderizes
tenderising = tenderizing
terrorisation = terrorization
terrorise = terrorize
terrorised = terrorized
terrorises = terrorizes
terrorising = terrorizing
teslascan = Teslascan
teveten = Teveten
thalassaemia = thalassemia
thalassaemias = thalassemias
thalassaemic = thalassemic
theater = theatre
theaters = theatres
thelin = Thelin
theologise = theologize
theologised = theologized
theologises = theologizes
theologising = theologizing
theorisation = theorization
theorise = theorize
theorised = theorized
theoriser = theorizer
theorisers = theorizers
theorises = theorizes
theorising = theorizing
thermaesthesia = thermesthesia
thermanaesthesia = thermanesthesia
thermoaesthesia = thermoesthesia
thermoanaesthesia = thermoanesthesia
thermohypaesthesia = thermohypesthesia
thermohyperaesthesia = thermohyperesthesia
thiaemia = thiemia
thiaemic = thiemic
thigmaesthesia = thigmesthesia
threadlike = thread-like
threefold = three-fold
thrombocythaemia = thrombocythemia
thrombocythaemic = thrombocythemic
thyrocoele = thyrocele
thyrogen = Thyrogen
thyrotropinreleasing = thyrotropin-releasing
thyroxin = thyroxine
tiazac = Tiazac
tisseel = Tisseel
titer = titre
titered = titred
titers = titres
toothlike = tooth-like
toothproducing = tooth-producing
topaesthesia = topesthesia
topamax = Topamax
topoanaesthesia = topoanesthesia
topothermaesthesiometer = topothermesthesiometer
toradol = Toradol
torisel = Torisel
totaled = totalled
totaling = totalling
toxaemia = toxemia
toxaemic = toxemic
toxanaemia = toxanemia
toxanaemic = toxanemic
tracleer = Tracleer
traditionalise = traditionalize
traditionalised = traditionalized
traditionalises = traditionalizes
traditionalising = traditionalizing
tramacet = Tramacet
tranquilisation = tranquilization
tranquilise = tranquilize
tranquilised = tranquilized
tranquiliser = tranquilizer
tranquilisers = tranquilizers
tranquilises = tranquilizes
tranquilising = tranquilizing
tranquillization = tranquillisation
tranquillize = tranquillise
tranquillized = tranquillised
tranquillizer = tranquilliser
tranquillizers = tranquillisers
tranquillizes = tranquillises
tranquillizing = tranquillising
transischaemia = transischemia
transischaemic = transischemic
transistorise = transistorize
transistorised = transistorized
transistorises = transistorizes
transistorising = transistorizing
transoesophageal = transesophageal
traumatise = traumatize
traumatised = traumatized
traumatises = traumatizes
traumatising = traumatizing
travatan = Travatan
traveled = travelled
traveler = traveller
travelers = travellers
traveling = travelling
treelike = tree-like
trelstar = Trelstar
trichoaesthesia = trichoesthesia
trichoanaesthesia = trichoanesthesia
tridural = Tridural
triglyceridaemia = triglyceridemia
triglyceridaemic = triglyceridemic
trileptal = Trileptal
trivialisation = trivialization
trivialise = trivialize
trivialised = trivialized
trivialises = trivializes
trivialising = trivializing
trovan = Trovan
trusopt = Trusopt
truvada = Truvada
tuberculocoele = tuberculocele
tularaemia = tularemia
tularaemic = tularemic
tumor = tumour
tumors = tumours
tumourbearing = tumour-bearing
twofold = two-fold
tygacil = Tygacil
tykerb = Tykerb
tylan = Tylan
tylenol = Tylenol
tyrannise = tyrannize
tyrannised = tyrannized
tyrannises = tyrannizes
tyrannising = tyrannizing
tyrosinaemia = tyrosinemia
tyrosinaemic = tyrosinemic
tysabri = Tysabri
ulorrhoea = ulorrhea
ultiva = Ultiva
unanaesthetized = unanesthetized
unappetise = unappetize
unappetised = unappetized
unappetises = unappetizes
unappetising = unappetizing
unauthorise = unauthorize
unauthorised = unauthorized
unauthorises = unauthorizes
unauthorising = unauthorizing
uncapitalise = uncapitalize
uncapitalised = uncapitalized
uncapitalises = uncapitalizes
uncapitalising = uncapitalizing
uncategorise = uncategorize
uncategorised = uncategorized
uncategorises = uncategorizes
uncategorising = uncategorizing
uncharacterise = uncharacterize
uncharacterised = uncharacterized
uncharacterises = uncharacterizes
uncharacterising = uncharacterizing
uncivilise = uncivilize
uncivilised = uncivilized
uncivilises = uncivilizes
uncivilising = uncivilizing
uncompromise = uncompromize
uncompromised = uncompromized
uncompromises = uncompromizes
uncompromising = uncompromizing
underandrogenization = under-androgenization
undercapitalise = undercapitalize
undercapitalised = undercapitalized
undercapitalises = undercapitalizes
undercapitalising = undercapitalizing
undernutrition = under-nutrition
underreplacement = under-replacement
undertreated = under-treated
underutilisation = underutilization
underutilise = underutilize
underutilised = underutilized
underutilises = underutilizes
underutilising = underutilizing
undervirilizationisation = undervirilization
undramatise = undramatize
undramatised = undramatized
undramatises = undramatizes
undramatising = undramatizing
unfavorable = unfavourable
unfavorably = unfavourably
unfertilise = unfertilize
unfertilised = unfertilized
unfertilises = unfertilizes
unfertilising = unfertilizing
unimmunizedised = unimmunized
unindustrialise = unindustrialize
unindustrialised = unindustrialized
unindustrialises = unindustrializes
unindustrialising = unindustrializing
unionisation = unionization
unionise = unionize
unionised = unionized
unionises = unionizes
unionising = unionizing
unitisation = unitization
unitise = unitize
unitised = unitized
unitises = unitizes
unitising = unitizing
unitron = Unitron
universalise = universalize
universalised = universalized
universalises = universalizes
universalising = universalizing
unmechanise = unmechanize
unmechanised = unmechanized
unmechanises = unmechanizes
unmechanising = unmechanizing
unorganise = unorganize
unorganised = unorganized
unorganises = unorganizes
unorganising = unorganizing
unpasteurise = unpasteurize
unpasteurised = unpasteurized
unpasteurises = unpasteurizes
unpasteurising = unpasteurizing
unraveled = unravelled
unraveling = unravelling
unrealisable = unrealizable
unrealise = unrealize
unrealised = unrealized
unrealises = unrealizes
unrealising = unrealizing
unrecognisable = unrecognizable
unrecognise = unrecognize
unrecognised = unrecognized
unrecognises = unrecognizes
unrecognising = unrecognizing
unrivaled = unrivalled
unrivaling = unrivalling
unromanticise = unromanticize
unromanticised = unromanticized
unromanticises = unromanticizes
unromanticising = unromanticizing
unsavory = unsavoury
unspecialise = unspecialize
unspecialised = unspecialized
unspecialises = unspecializes
unspecialising = unspecializing
unsubsidise = unsubsidize
unsubsidised = unsubsidized
unsubsidises = unsubsidizes
unsubsidising = unsubsidizing
unsupervise = unsupervize
unsupervised = unsupervized
unsupervises = unsupervizes
unsupervising = unsupervizing
unsynchronise = unsynchronize
unsynchronised = unsynchronized
unsynchronises = unsynchronizes
unsynchronising = unsynchronizing
unutilise = unutilize
unutilised = unutilized
unutilises = unutilizes
unutilising = unutilizing
uraemia = uremia
uraemic = uremic
uraemigenic = uremigenic
urbanisation = urbanization
urbanise = urbanize
urbanised = urbanized
urbanises = urbanizes
urbanising = urbanizing
uresiaesthesia = uresiesthesia
uresiaesthesis = uresiesthesis
ureterocoele = ureterocele
ureterocoelectomy = ureterocelectomy
ureterocoeles = ureteroceles
urethrocoele = urethrocele
uriaesthesis = uriesthesis
uricacidaemia = uricacidemia
uricacidaemic = uricacidemic
uricaemia = uricemia
uricaemic = uricemic
urinaemia = urinemia
urinaemic = urinemic
urobilinaemia = urobilinemia
urobilinaemic = urobilinemic
urobilinogenaemia = urobilinogenemia
urobilinogenaemic = urobilinogenemic
urocoele = urocele
uroedema = uredema
urohaematoporphyrin = urohematoporphyrin
urorrhoea = urorrhea
uroscheocoele = uroscheocele
urso = Urso
uterocoele = uterocele
utilisable = utilizable
utilisation = utilization
utilise = utilize
utilised = utilized
utilises = utilizes
utilising = utilizing
vacuolisation = vacuolization
vaginocoele = vaginocele
valcyte = Valcyte
valor = valour
valorisation = valorization
valorise = valorize
valorised = valorized
valorises = valorizes
valorising = valorizing
valtrex = Valtrex
valvelike = valve-like
vandalise = vandalize
vandalised = vandalized
vandalises = vandalizes
vandalising = vandalizing
vaniqa = Vaniqa
vapor = vapour
vaporisable = vaporizable
vaporisation = vaporization
vaporise = vaporize
vaporised = vaporized
vaporiser = vaporizer
vaporisers = vaporizers
vaporises = vaporizes
vaporising = vaporizing
vapors = vapours
varicocoele = varicocele
varicocoelectomy = varicocelectomy
varicocoeles = varicoceles
vascularizationisation = vascularization
vascularizedised = vascularized
vasopressinstimulated = vasopressin-stimulated
vasovist = Vasovist
velcade = Velcade
ventolin = Ventolin
verbalisation = verbalization
verbalise = verbalize
verbalised = verbalized
verbalises = verbalizes
verbalising = verbalizing
vesicare = Vesicare
vesicocoele = vesicocele
vestlike = vest-like
vfend = Vfend
viagra = Viagra
victimisation = victimization
victimise = victimize
victimised = victimized
victimiser = victimizer
victimisers = victimizers
victimises = victimizes
victimising = victimizing
videx = Videx
vigamox = Vigamox
vigor = vigour
viracept = Viracept
viraemia = viremia
viraemic = viremic
viramune = Viramune
viread = Viread
virilizedised = virilized
virtualise = virtualize
virtualised = virtualized
virtualises = virtualizes
virtualising = virtualizing
virusaemia = virusemia
virusaemic = virusemic
vistide = Vistide
visualisation = visualization
visualise = visualize
visualised = visualized
visualises = visualizes
visualising = visualizing
visudyne = Visudyne
vitalisation = vitalization
vitalise = vitalize
vitalised = vitalized
vitalises = vitalizes
vitalising = vitalizing
vivelle = Vivelle
vocalisation = vocalization
vocalise = vocalize
vocalised = vocalized
vocalises = vocalizes
vocalising = vocalizing
volatilisation = volatilization
volatilise = volatilize
volatilised = volatilized
volatilises = volatilizes
volatilising = volatilizing
volibris = Volibris
voltaren = Voltaren
vulcanisation = vulcanization
vulcanise = vulcanize
vulcanised = vulcanized
vulcanises = vulcanizes
vulcanising = vulcanizing
vulgarisation = vulgarization
vulgarise = vulgarize
vulgarised = vulgarized
vulgarises = vulgarizes
vulgarising = vulgarizing
warlike = war-like
waterpermeable = water-permeable
wavelike = wave-like
weatherise = weatherize
weatherised = weatherized
weatherises = weatherizes
weatherising = weatherizing
weightbearing = weight-bearing
wellbutrin = Wellbutrin
westernisation = westernization
westernise = westernize
westernised = westernized
westernises = westernizes
westernising = westernizing
whiplike = whip-like
winterisation = winterization
winterise = winterize
winterised = winterized
winterises = winterizes
winterising = winterizing
womanise = womanize
womanised = womanized
womaniser = womanizer
womanisers = womanizers
womanises = womanizes
womanising = womanizing
woodlike = wood-like
workup = work-up
wormlike = worm-like
xalatan = Xalatan
xamiol = Xamiol
xanthaemia = xanthemia
xanthaemic = xanthemic
xarelto = Xarelto
xatral = Xatral
xeloda = Xeloda
xenical = Xenical
xigris = Xigris
xolair = Xolair
xray = X-ray
xyntha = Xyntha
xyrem = Xyrem
yarvitan = Yarvitan
yasmin = Yasmin
yaz = Yaz
yearend = year-end
yearlong = year-long
yieldfree = yield-free
zantac = Zantac
zeftera = Zeftera
zeldox = Zeldox
zemplar = Zemplar
zenapax = Zenapax
zeniquin = Zeniquin
ziagen = Ziagen
zilmax = Zilmax
zithromax = Zithromax
zocor = Zocor
zofran = Zofran
zolinza = Zolinza
zoloft = Zoloft
zometa = Zometa
zomig = Zomig
zonaesthesia = zonesthesia
zovirax = Zovirax
zyban = Zyban
zymar = Zymar
zyprexa = Zyprexa
zytram = Zytram
zyvoxam = Zyvoxam
